aanbestedende dienst	Common_Term
aanbestedende diensten	Common_Term
aanbesteding	Common_Term
aanbestedingsmarkt	Specific_Term
aanbestedingsprocedure	Common_Term
aanbestedingsprocedures	Common_Term
aangifte	Common_Term
aanhoudingsbevel	Common_Term
aanklager	Common_Term
aanklagers	Common_Term
aankoopdirecteur	Common_Term
aansprakelijk	Common_Term
aansprakelijkheid	Common_Term
aanzetting	Common_Term
abb	OOD_Term
abm	OOD_Term
accountant	Common_Term
accountants	Common_Term
accountantsbureaus	Common_Term
accountantscontrole	Common_Term
accountantskantoren	Common_Term
accountantsonderzoek	Specific_Term
acquis	Specific_Term
actieplan	Specific_Term
actieve corruptie	Specific_Term
activa	Specific_Term
activiteitsgestuurd beheer	OOD_Term
activiteitsgestuurde begroting	OOD_Term
administratie	Common_Term
administratief	Common_Term
administratief onderzoek	Common_Term
administratief strafrecht	Common_Term
administraties	Common_Term
administratieve	Common_Term
administratieve fraudeonderzoeken	Specific_Term
administratieve raad voor toetsing	Specific_Term
advocaten	Common_Term
afpersing	Common_Term
afromen	Common_Term
aftrek	Common_Term
aftrekbaar	Common_Term
aftrekbaarheid	Common_Term
algemeen belang	Common_Term
algemene raad	Specific_Term
algemene vergadering	Common_Term
amb	OOD_Term
ambt	Common_Term
ambtelijke	Common_Term
ambtenaar	Common_Term
ambtenaren	Common_Term
ambtenarenstatuut	Specific_Term
ambtsaanvaarding	Specific_Term
ambtshalve	Specific_Term
ambtsmisdrijven	Common_Term
amendementen	Common_Term
anomalieën	Common_Term
anti-corruptiebeleid	Common_Term
anti-corruptiecultuur	Common_Term
anti-corruptiedienst	Common_Term
anti-corruptiediensten	Common_Term
anti-corruptienetwerk	Common_Term
anti-fraudedienst	Common_Term
anticorruptie-eenheid	Specific_Term
anticorruptiebepalingen	Common_Term
anticorruptieovereenkomst	Specific_Term
anticorruptiestrategie	Common_Term
arbeidsvoorwaarden	Specific_Term
audit	Specific_Term
auditcomité	Specific_Term
auditcomitémandaat	Specific_Term
auditstandaarden	Specific_Term
aut dedere aut judicare-regel	Specific_Term
autoriteit	Common_Term
autoriteiten	Common_Term
bank	Common_Term
banken	Common_Term
bankgeheimwetten	Specific_Term
bankwezen	Common_Term
basisdelicten	Specific_Term
bbp	Common_Term
beambten	Common_Term
bedragen	Common_Term
bedrijf	Common_Term
bedrijfsleven	Common_Term
bedrijfspersoneel	Common_Term
bedrijfspraktijken	Common_Term
bedrijfsrekeningen	Common_Term
bedrijven	Common_Term
begroting	Common_Term
begrotingsaangelegenheden	Common_Term
begrotingsgebied	Common_Term
begrotingsonderde(e)l(en)	Specific_Term
begrotingsonderdelen	Specific_Term
begrotingszaken	Common_Term
behoorlijk bestuur	Specific_Term
belangeloosheid	Specific_Term
belangenconflict	Common_Term
belangenconflicten	Common_Term
belangengroepen	Common_Term
belangenverstrengeling	Common_Term
belastbare	Common_Term
belastbare basis	Specific_Term
belastingadviseurs	Common_Term
belastingbetaler	Common_Term
belastingbetalers	Common_Term
belastingbetalingen	Common_Term
belastingen	Common_Term
beleid	Common_Term
beleid inzake corruptiebestrijding	Common_Term
beleid ter bestrijding van corruptie	Common_Term
beleid voor de bestrijding van corruptie	Common_Term
beleidsdoelstellingen	Common_Term
beleidsdomeinen	Common_Term
beleidsmaatregelen	Common_Term
beleidsniveaus	Common_Term
beleidsontwikkeling	Common_Term
beleidsterrein	Common_Term
beleidsterreinen	Common_Term
beleidsvormen	Common_Term
belemmeren van de rechtsgang	Specific_Term
belgische strafwetboek	Specific_Term
beloning	Common_Term
bemiddelingspanel	Specific_Term
beoordelingsmechanisme	Common_Term
berechting	Common_Term
beroep	Common_Term
beroepsgeheim	Common_Term
beroepsmogelijkheden	Common_Term
beroepsmoraal	Common_Term
beroepsvoorschriften	Common_Term
bescherming van persoonsgegevens	Common_Term
beschikkingen	Specific_Term
beschuldigingen	Common_Term
besluit	Specific_Term
besluiten	Specific_Term
bestraffend	Common_Term
bestraffing	Common_Term
bestraft	Common_Term
bestrijden van corruptie	Common_Term
bestrijding van corruptie	Common_Term
bestrijding van fraude	Common_Term
bestrijding van omkoping	Common_Term
bestrĳding van corruptie	Common_Term
besturen	Common_Term
bestuur	Common_Term
bestuurders	Common_Term
bestuurlijke	Common_Term
bestuurlijke capaciteit	Specific_Term
bestuurlijke gedragscode	Common_Term
bestuursrechtelijk	Common_Term
bestuursrechtelijk onderzoek	Common_Term
betaal	Common_Term
betaald	Common_Term
betaalde	Common_Term
betaalt	Common_Term
betalen	Common_Term
betaling	Common_Term
beurzen	Common_Term
bevriezen	Specific_Term
bevriezing	Specific_Term
bevriezing van voorwerpen	Specific_Term
bewijsgaring	Specific_Term
bewijskracht	Common_Term
bewijslast	Common_Term
bewijsmateriaal	Common_Term
bewijsstukken	Common_Term
bewijsvoering	Specific_Term
bezoldigd	Common_Term
bezoldiging	Common_Term
bijdrage	Common_Term
binnenlandse zaken	Common_Term
blacklist	Common_Term
boekhouders	Common_Term
boekhouding	Common_Term
boekhoudkundige	Common_Term
boekhoudkundige anomalieën	Common_Term
boekhoudkundige misdrijven	Common_Term
boekhoudnormen	Common_Term
budget	Common_Term
budgettaire	Common_Term
buitenboekhoudkundige	Specific_Term
buitenboekhoudkundige rekeningen	Specific_Term
bureaucratisering	Common_Term
burgerrechtelijk	Common_Term
chantage	Common_Term
civiele	Common_Term
civiele maatschappij	Common_Term
civiele samenleving	Common_Term
civielrechtelijke	Common_Term
clausule	Common_Term
code met ethische criteria	Common_Term
cohesiebeleid	Specific_Term
collusie	Specific_Term
commerciële	Common_Term
commerciële transacties	Common_Term
commissie	Common_Term
commissies	Common_Term
communautaire recht	Specific_Term
compromitteert	Common_Term
concessies	Common_Term
concurrentie	Common_Term
concurrentievervalsing	Specific_Term
confiscatie	Common_Term
confiscatie van criminele vermogensbestanddelen	Specific_Term
confiscatie van de opbrengsten van misdrijven	Specific_Term
confiscatie van vermogensbestanddelen	Specific_Term
confiscaties	Common_Term
confisqueren	Common_Term
contract	Common_Term
contractant	Common_Term
contracten	Common_Term
controleerbaarheid	Common_Term
corrupt	Common_Term
corrupt gedrag	Common_Term
corrupte	Common_Term
corrupte activiteiten	Common_Term
corrupte bedrijfspraktijken	Common_Term
corrupte gedragingen	Common_Term
corrupte handelingen	Common_Term
corrupte praktijken	Common_Term
corruptie	Common_Term
corruptie te bestrijden	Common_Term
corruptie-element	Specific_Term
corruptiebestrijders	Common_Term
corruptiebestrijding	Common_Term
corruptiebestrijdingsautoriteiten	Specific_Term
corruptiebestrijdingsbeleid	Common_Term
corruptiebestrijdingshervormingen	Common_Term
corruptiebestrijdingsinstanties	Common_Term
corruptiebestrijdingsinstrumenten	Common_Term
corruptiebestrijdingskwesties	Common_Term
corruptiebestrijdingsmaatregelen	Common_Term
corruptiebestrijdingsnormen	Common_Term
corruptiebestrijdingspakket	Common_Term
corruptiebestrijdingsverslag	Specific_Term
corruptiebestrijdingswetgeving	Common_Term
corruptiecultuur	Common_Term
corruptiedelicten	Common_Term
corruptiegeval	Common_Term
corruptiegevallen	Common_Term
corruptiegraad	Common_Term
corruptiemisdrijven	Common_Term
corruptieperceptie-index	Specific_Term
corruptiepogingen	Common_Term
corruptiepraktijken	Common_Term
corruptiepreventie	Common_Term
corruptieproblematiek	Common_Term
corruptieprotocol	Specific_Term
corruptieschandalen	Common_Term
corruptiezaken	Common_Term
criminaliseren	Common_Term
criminalisering	Common_Term
criminaliteit	Common_Term
criminaliteitsfenomeen	Common_Term
crimineel	Common_Term
crimineel gedrag	Common_Term
crimineel verkregen vermogen	Specific_Term
criminele	Common_Term
criminele misbruiken	Common_Term
criminele organisatie	Common_Term
criminele vermogensbestanddelen	Specific_Term
criminelen	Common_Term
culpoos gedrag	Specific_Term
daad van corruptie	Common_Term
dader	Common_Term
daders	Common_Term
delict	Common_Term
delict inzake heffingen	Specific_Term
delicten	Common_Term
delinquentie	Common_Term
deontologie	Specific_Term
deontologisch	Specific_Term
deontologisch kader	Specific_Term
deontologische	Specific_Term
deontologische codes	Specific_Term
derde	Common_Term
derden	Common_Term
derden te goeder trouw	Specific_Term
deviezenmarkten	Specific_Term
dialoog tussen overheid en bedrijfsleven	Specific_Term
dienstverleningsopdrachten	Common_Term
dienstverleningsopdrachten voor openbare werken	Common_Term
dienstverrichtingscontracten	Common_Term
directe recuperatie van activa	Specific_Term
disciplinaire	Common_Term
douane	Common_Term
douaneautoriteiten	Common_Term
douanerechten	Common_Term
dubbele controle	Specific_Term
dubbele strafbaarstelling	Specific_Term
duistere	Specific_Term
economie	Common_Term
economisch	Common_Term
economische	Common_Term
economische activiteiten	Common_Term
economische misdrijven	Common_Term
economische schade	Common_Term
eerlijke mededinging	Specific_Term
erkenningen	Common_Term
ernstige strafbare feiten	Specific_Term
ernstige wanpraktijken	Common_Term
ethiek	Common_Term
ethisch	Common_Term
ethisch comité	Specific_Term
ethisch gedrag	Common_Term
ethisch ondernemerschap	Specific_Term
ethische	Common_Term
ethische criteria	Common_Term
europees aanhoudingsbevel	Specific_Term
evaluatiemechanisme	Common_Term
evaluatiemechanismen	Common_Term
evaluatieopdrachten	Specific_Term
expertise-unit in strafrechtelijke zaken	Specific_Term
exportkredieten	Specific_Term
externe accountant	Specific_Term
externe accountants	Specific_Term
externe corruptie	Specific_Term
externe financiële controle	Common_Term
externe kwaliteitsborging	Specific_Term
externe-auditdiensten	Specific_Term
favoritisme	Common_Term
federaal administratief openbaar ambt	Specific_Term
federale gerechtelijke politie	Specific_Term
federale overheidsdienst	Specific_Term
federale overheidsdiensten	Specific_Term
financieel	Common_Term
financieel beheer	Common_Term
financieel belang	Common_Term
financieel beleid	Common_Term
financieel memorandum	Specific_Term
financieel onderzoek	Common_Term
financieel reglement	Specific_Term
financieel voordeel	Common_Term
financiering	Common_Term
financiering van politieke partijen	Common_Term
financiering van terrorisme	Specific_Term
financiering van verkiezingscampagnes	Common_Term
financieringsovereenkomsten	Common_Term
financiële	Common_Term
financiële belangen	Common_Term
financiële criminaliteit	Common_Term
financiële crisis	Common_Term
financiële inlichtingen	Common_Term
financiële inlichtingeneenheden	Specific_Term
financiële inlichtingeneenheid	Specific_Term
financiële kader	Specific_Term
financiële kosten	Common_Term
financiële misdrijven	Common_Term
financiële onderzoeken	Common_Term
financiële onregelmatigheden	Common_Term
financiële stelsel	Specific_Term
financiële strafonderzoeken	Common_Term
financiële transacties	Common_Term
financiële verslaggeving	Specific_Term
financiën	Common_Term
fiscale	Common_Term
fiscale aftrek	Common_Term
fiscale aftrekbaarheid	Common_Term
fiscale exceptie	Specific_Term
fiscale misdrijven	Common_Term
fiscale wetgeving	Common_Term
fod	Specific_Term
fraude	Common_Term
fraudeactiviteiten	Common_Term
fraudebestrijding	Common_Term
fraudebestrijdingsbeleid	Common_Term
fraudebestrijdingskader	Specific_Term
fraudebestrijdingsnetwerk	Specific_Term
fraudebestrijdingsstrategie	Common_Term
fraudedelicten	Common_Term
fraudegevoelige karakter	Common_Term
fraudegevoeligheid	Common_Term
fraudeonderzoeken	Common_Term
fraudepreventie	Common_Term
frauderen	Common_Term
fraudes	Common_Term
functiemisbruik	Specific_Term
functionarissen	Common_Term
fundamentele ethische plichten	Specific_Term
g-20	Specific_Term
geconfisqueerd	Common_Term
geconsolideerde jaarrekeningen	Specific_Term
gedragcodes	Common_Term
gedragscode	Common_Term
gedragscodes	Common_Term
gedragsnormen	Common_Term
gedragsprincipes	Common_Term
gedragsregels	Common_Term
gefinancierd	Common_Term
gefinancierde	Common_Term
gegevensbescherming	Common_Term
geheimhouding	Common_Term
geheimhoudingsplicht	Common_Term
geld	Common_Term
geldboete	Common_Term
geldboetes	Common_Term
gelden	Common_Term
geldwitwasrichtlijn	Specific_Term
gemeenschappelijk optreden	Specific_Term
gemeenschappelijk toezichtsmechanisme	Specific_Term
gemeenschappelijke markt	Specific_Term
georganiseerde corruptie	Specific_Term
georganiseerde criminaliteit	Common_Term
georganiseerde en grensoverschrijdende corruptie	Specific_Term
georganiseerde en grensoverschrijdende fraude	Specific_Term
georganiseerde financiële criminaliteit	Common_Term
georganiseerde internationale fraude	Common_Term
georganiseerde misdaad	Common_Term
georganiseerde misdaadbendes	Common_Term
gerecht	Common_Term
gerecht van eerste aanleg	Specific_Term
gerechtelijke	Common_Term
gerechtelijke autoriteit	Common_Term
gerechtelijke autoriteiten	Common_Term
gerechtelijke sancties	Common_Term
gerechtelijke vervolging	Common_Term
gerechtigden	Common_Term
geschenken	Common_Term
geschil	Common_Term
geschillen	Common_Term
geseponeerd	Specific_Term
gestraft	Common_Term
getuigen	Common_Term
gevallen van corruptie	Common_Term
gevangenisstraf	Common_Term
gevorderd	Common_Term
gezamenlijk toezichthoudende teams	Specific_Term
geïnvesteerde	Common_Term
goed bestuur	Specific_Term
goederen	Common_Term
governance	Specific_Term
governance-indicatoren	Specific_Term
gratificatie	Specific_Term
grensoverschrijdende corruptie	Specific_Term
grensoverschrijdende fraude	Specific_Term
grensoverschrijdende gevallen van corruptie	Specific_Term
grensoverschrijdende omkoping	Specific_Term
grijze zones	Common_Term
groenboek	Specific_Term
gronddelicten	Specific_Term
grondwettelijke	Common_Term
grondwettelijke bepalingen	Common_Term
gtm	Specific_Term
gunning van overheidsopdrachten	Specific_Term
handel	Common_Term
handel in invloed	Specific_Term
handelen	Common_Term
handelsassociaties	Common_Term
handelsbeleid	Common_Term
handelsbetrekkingen	Common_Term
handelsgeschil	Specific_Term
handelspolitiek	Common_Term
handelsrelaties	Common_Term
handelstransacties	Common_Term
handhavingsmaatregelen	Common_Term
heffingen	Common_Term
hof	Common_Term
hof van justitie	Specific_Term
ias	Specific_Term
illegaal	Common_Term
illegale	Common_Term
illegale activiteiten	Common_Term
illegale financiering	Common_Term
illegale opbrengst	Common_Term
illegale voordelen	Common_Term
immuniteiten	Common_Term
in beslag nemen	Common_Term
inbeslagneming	Common_Term
inbeslagnemingen	Common_Term
inbreuk	Common_Term
inbreuken	Common_Term
index van de perceptie van corruptie	Specific_Term
indirect financieel voordeel	Common_Term
informanten	Common_Term
ingetrokken	Common_Term
inkomsten	Common_Term
inschrijver	Specific_Term
inschrijvers	Specific_Term
inschrijving bij toewijzingen van de eigendom	Specific_Term
instrumenten voor corruptiebestrijding	Specific_Term
integere	Common_Term
integriteit	Common_Term
integriteitsbeleid	Specific_Term
integriteitsnormen	Common_Term
integriteitssystemen	Specific_Term
integriteitstrainingen	Common_Term
intergouvernementeel	Common_Term
intergouvernementele	Common_Term
intern onderzoek	Specific_Term
internationale fraude	Common_Term
internationale markt	Common_Term
internationale standaarden voor accountantscontrole	Specific_Term
internationale standaarden voor financiële verslaggeving	Specific_Term
internationale standaarden voor jaarrekeningen	Specific_Term
interne audit	Specific_Term
interne beroepsmogelijkheden	Common_Term
interne controle	Specific_Term
interne markt	Specific_Term
interne onderzoek	Specific_Term
interne onderzoeken	Specific_Term
interpretatieve rechtsbevoegdheid	Specific_Term
intrekking	Common_Term
investering	Common_Term
investeringen	Common_Term
investeringsniveau	Specific_Term
isa	Specific_Term
jaarrekeningen	Specific_Term
joint venture	OOD_Term
juridisch	Common_Term
juridische	Common_Term
juridische bevoegdheden	Common_Term
juridische context	Common_Term
juridische kader	Common_Term
juridische referentiekader	Specific_Term
jurisprudentie	Specific_Term
justitie	Common_Term
justitieel	Common_Term
justitieel onderzoek	Common_Term
justitiële	Common_Term
justitiële autoriteiten	Common_Term
kaderbesluit	Specific_Term
kaderbesluiten	Specific_Term
kaderovereenkomsten	Specific_Term
kaderverordening	Specific_Term
kapitaalmarkt	Specific_Term
klacht	Common_Term
kleine corruptie	Specific_Term
kleine en middelgrote ondernemingen	Common_Term
kleinschalige corruptie	Specific_Term
klokkenluiders	Common_Term
koninklijk besluit	Specific_Term
koninklijke besluiten	Specific_Term
kosten	Common_Term
kostenraming	Common_Term
kredieten	Common_Term
kredietinstelling	Common_Term
kredietinstellingen	Common_Term
kwaliteitsborging	Specific_Term
lastgever	Specific_Term
legale	Common_Term
legale economie	Specific_Term
lobby	Specific_Term
loyauteit	Common_Term
loyauteitsplicht	Specific_Term
maatregelen voor corruptiebestrijding	Common_Term
maatschappelijk	Common_Term
maatschappelijk middenveld	Common_Term
maatschappelijk verantwoord	Common_Term
maatschappelijke	Common_Term
maatschappelijke verantwoordelijkheid	Common_Term
maatschappij	Common_Term
magistraat	Specific_Term
magistraten	Specific_Term
magistratuur	Common_Term
management	Common_Term
mandaat	Common_Term
markt	Common_Term
markten	Common_Term
marktprocedures	Specific_Term
marktvoorwaarden	Common_Term
materiële strafrecht	Common_Term
mechanisme voor follow-up	Common_Term
mechanisme voor samenwerking en toetsing	Specific_Term
mededinging	Specific_Term
medefinanciering	Common_Term
medeplichtige	Common_Term
medeplichtigen	Common_Term
medeplichtigheid	Common_Term
medewerkers	Common_Term
meerkost	Common_Term
memorandum van overeenstemming	Specific_Term
midden- en kleinbedrijf	Common_Term
minimumregels	Common_Term
misbruik	Common_Term
misbruik van de positie	Common_Term
misbruik van macht	Common_Term
misdaad	Common_Term
misdaadbendes	Common_Term
misdaadbestrijding	Common_Term
misdaadpreventie	Common_Term
misdaadstatistieken	Common_Term
misdrijf	Common_Term
misdrijven	Common_Term
modus operandi	Specific_Term
monetairbeleidsbeslissingen	Specific_Term
monopolies	Common_Term
nabuurschap	Specific_Term
nabuurschapsbeleid	Specific_Term
nalevingsverslagen	Specific_Term
natuurlijk persoon	Specific_Term
natuurlijke personen	Specific_Term
natuurlijke persoon	Specific_Term
natuurlĳke personen	Specific_Term
ne bis in idem-regel	Specific_Term
netwerk van corruptiebestrijding	Specific_Term
netwerk voor corruptiebestrijding	Specific_Term
ngo	Common_Term
ngo's	Common_Term
niet strafrechtelijke geldboetes	Specific_Term
niet-contractuele aansprakelijkheid	Specific_Term
niet-gerechtvaardigd voordeel	Specific_Term
niet-gouvernementele organisatie	Common_Term
niet-verschuldigd voordeel	Specific_Term
niet‑transparante	Common_Term
notarissen	Common_Term
objectief	Common_Term
officier van justitie	Common_Term
officier van politie	Common_Term
omgekocht	Common_Term
omgekochte	Common_Term
omgezet	Specific_Term
omkoopt	Common_Term
omkoopzaken	Common_Term
omkopen	Common_Term
omkoper	Common_Term
omkoping	Common_Term
omkopingsrisico's	Common_Term
omzetting	Specific_Term
onafhankelijkheid van de rechtspleging	Specific_Term
onderaanneming	Common_Term
onderneming	Common_Term
ondernemingen	Common_Term
onderzoeksbevoegdheid	Common_Term
onderzoeksgeheim	Common_Term
ondubbelzinnige	Common_Term
ongeoorloofde beïnvloeding	Specific_Term
ongepaste voordelen	Specific_Term
onkosten	Common_Term
onpartijdig	Common_Term
onpartijdigheid	Common_Term
onrechtmatige betaling	Common_Term
onregelmatigheden	Common_Term
onroerend	Specific_Term
onroerende zaken	Common_Term
onschendbaarheid	Common_Term
ontbinding	Specific_Term
ontneming van crimineel verkregen vermogen	Specific_Term
ontneming van vermogensbestanddelen	Specific_Term
onttrekking	Specific_Term
onttrekking van instrumenten	Specific_Term
onttrekking van instrumenten en opbrengst	Specific_Term
onttrekking van instrumenten en opbrengsten	Specific_Term
ontwerpbegroting	Specific_Term
ontwettige	Common_Term
ontwettige activiteit	Common_Term
ontwikkelingshulp	Common_Term
onwettelijke	Common_Term
onwettelijke activiteiten	Common_Term
onwettige	Common_Term
onwettige activiteit	Common_Term
onwettige activiteiten	Common_Term
onwettige verrijking	Specific_Term
opbrengst	Common_Term
opbrengsten	Common_Term
opbrengsten van misdrijven	Common_Term
opdecimes	Specific_Term
open markten	Common_Term
openbaar	Common_Term
openbaar ambt	Common_Term
openbaar bestuur	Common_Term
openbaar gezag	Common_Term
openbare	Common_Term
openbare aanbesteding	Common_Term
openbare aanbestedingen	Common_Term
openbare aangelegenheden	Common_Term
openbare aanklager	Common_Term
openbare aanklagers	Common_Term
openbare administraties	Common_Term
openbare besturen	Common_Term
openbare dienst	Common_Term
openbare diensten	Common_Term
openbare eigendommen	Common_Term
openbare financiën	Common_Term
openbare functie	Common_Term
openbare inschrijving	Specific_Term
openbare instelling	Common_Term
openbare instellingen	Common_Term
openbare macht	Common_Term
openbare sector	Common_Term
openbare werken	Common_Term
openbaredienstverlener	Common_Term
openbaredienstverleningstaak	Common_Term
opgave van financiële belangen	Specific_Term
opgave van hun financiële belangen	Specific_Term
opheffing van toepasselijke vrijstelling van rechtsvervolging	Specific_Term
opheffing van vrijstelling van rechtsvervolging	Specific_Term
opheffingen van vrijstelling van rechtsvervolging	Specific_Term
overdracht van vervolging	Specific_Term
overheden	Common_Term
overheid	Common_Term
overheidsaanbestedingen	Common_Term
overheidsadministraties	Common_Term
overheidsambtenaar	Common_Term
overheidsambtenaren	Common_Term
overheidsboekhouding	Common_Term
overheidsdienst	Common_Term
overheidsdiensten	Common_Term
overheidsfinanciën	Common_Term
overheidsfunctionarissen	Common_Term
overheidsgeld	Common_Term
overheidslichamen	Common_Term
overheidsopdrachten	Common_Term
overheidstoezicht	Common_Term
overheidsuitgaven	Common_Term
overtreden	Common_Term
overtreder	Common_Term
overtreding	Common_Term
parket	Common_Term
particuliere	Common_Term
particuliere sector	Common_Term
partijfinanciering	Common_Term
passieve corruptie	Specific_Term
passieve omkoping	Specific_Term
personeelsverordeningen	Specific_Term
persoonlijk belang	Common_Term
persoonlijke rechtsbijstand	Common_Term
plegers van fraude	Common_Term
plicht verzuimt	Specific_Term
plichtsverzuim	Specific_Term
politici	Common_Term
politie	Common_Term
politiediensten	Common_Term
politieel	Common_Term
politiek	Common_Term
politiek akkoord	Common_Term
politieke	Common_Term
politieke corruptie	Common_Term
politieke corruptieschandalen	Common_Term
politieke partijen	Common_Term
politieke schandalen	Common_Term
politionele	Common_Term
politiële	Common_Term
prejudiciële	Specific_Term
prejudiciële beslissing	Specific_Term
prejudiciële beslissingen	Specific_Term
prejudiciële uitlegging	Specific_Term
prijs	Common_Term
private	Common_Term
private corruptie	Specific_Term
private omkoping	Specific_Term
private sector	Common_Term
privatiseringen	Common_Term
privé	Common_Term
privé-eigendom	Common_Term
privé-sector	Common_Term
privésector	Common_Term
procedurele garanties	Specific_Term
professionele contacten	Common_Term
professionele integriteit	Common_Term
prudentieel toezicht	Specific_Term
publieke	Common_Term
publieke domein	Common_Term
publieke omkoping	Specific_Term
publieke rapportering	Common_Term
publieke sector	Common_Term
publiekrechtelijke	Common_Term
publiekrechtelijke organen	Common_Term
raad van bestuur	Specific_Term
raad van toezicht	Specific_Term
raadgevend comité	Specific_Term
raadgevend comité voor het gedrag van de leden	Specific_Term
raden van bestuur	Common_Term
rapportagemechanisme	Common_Term
rapporteren	Common_Term
rapportering	Common_Term
rapporteur	Specific_Term
recht	Common_Term
recht te zwijgen	Common_Term
rechtbanken	Common_Term
rechten	Common_Term
rechter	Common_Term
rechterlijk	Common_Term
rechterlijk bevel	Specific_Term
rechterlijk bevel tot ontbinding	Specific_Term
rechterlijke	Common_Term
rechterlijke instantie	Common_Term
rechterlijke instanties	Common_Term
rechterlijke macht	Common_Term
rechterlijke toetsing	Specific_Term
rechters	Common_Term
rechtmatig	Common_Term
rechtmatige	Common_Term
rechtmatige diensten	Specific_Term
rechtsbescheiden	Specific_Term
rechtsbescherming	Specific_Term
rechtsbevoegdheid	Specific_Term
rechtsbijstand	Common_Term
rechtsgang	Common_Term
rechtsgebied	Common_Term
rechtsgevolg	Specific_Term
rechtsgrondslag	Specific_Term
rechtsgrondslagen	Specific_Term
rechtshandhavers	Common_Term
rechtshandhaving	Common_Term
rechtshandhavingsagentschappen	Common_Term
rechtshandhavingsambtenaren	Common_Term
rechtshandhavingsinstanties	Common_Term
rechtshandhavingsorganen	Common_Term
rechtshandhavingspersoneel	Common_Term
rechtshulp	Specific_Term
rechtsinstrument	Specific_Term
rechtsinstrumentarium	Specific_Term
rechtsinstrumenten	Specific_Term
rechtskader	Common_Term
rechtskader voor corruptiebestrijding	Specific_Term
rechtsmacht	Common_Term
rechtsmachtregels	Specific_Term
rechtsmiddelen	Common_Term
rechtspersonen	Specific_Term
rechtspersoon	Specific_Term
rechtspersoonlijke	Specific_Term
rechtspersoonlijke belastingbetaler	Specific_Term
rechtspleging	Specific_Term
rechtspraak	Common_Term
rechtsstaat	Common_Term
rechtsstelsel	Common_Term
rechtsstelsels	Common_Term
rechtstreekse algemene verkiezingen	Specific_Term
rechtsverkeer	Specific_Term
rechtsvervolging	Common_Term
rechtswerking	Specific_Term
rechtvaardige	Common_Term
rechtvaardigheid	Common_Term
recuperatie van activa	Specific_Term
regel	Common_Term
regelgevend kader	Common_Term
regelgeving	Common_Term
regels	Common_Term
regering	Common_Term
regeringen	Common_Term
regeringsleiders	Common_Term
reglement van orde	Specific_Term
reglementering	Common_Term
rekeningen	Common_Term
represailles	Common_Term
repressie	Common_Term
resolutie	Specific_Term
restitutie van wederrechtelijke verrijking	Specific_Term
richtlijn	Specific_Term
richtlijnen	Specific_Term
roerend	Specific_Term
salaris	Common_Term
samenleving	Common_Term
sanctie	Common_Term
sancties	Common_Term
schade te vergoeden	Common_Term
schadevergoeding	Common_Term
schending	Common_Term
schenkingen	Common_Term
schuldig	Common_Term
seponering	Specific_Term
slachtoffer	Common_Term
slachtoffers	Common_Term
smeergeld	Common_Term
sommen	Common_Term
standaardclausules	Common_Term
standaarden voor boekhouding	Specific_Term
statutair comité	Specific_Term
statutaire comité	Specific_Term
statutaire resolutie	Specific_Term
statuten	Specific_Term
statuut	Specific_Term
statuut van de ambtenaren	Specific_Term
steekpenningen	Common_Term
stelsel van algemene tariefpreferenties	Specific_Term
stem	Common_Term
stemmen	Common_Term
stemrecht	Common_Term
stemvrijheid	Specific_Term
strafbaar	Common_Term
strafbaar feit	Common_Term
strafbaarstelling	Common_Term
strafbaarstellingen	Common_Term
strafbare	Common_Term
strafbare feit	Common_Term
strafbare feiten	Common_Term
strafbepalingen	Common_Term
straffen	Common_Term
strafmaatregelen	Common_Term
strafonderzoeken	Common_Term
strafproces	Common_Term
strafrecht	Common_Term
strafrechtelijk	Common_Term
strafrechtelijk aansprakelijk	Common_Term
strafrechtelijk delict	Common_Term
strafrechtelijke	Common_Term
strafrechtelijke aansprakelijkheid	Common_Term
strafrechtelijke geldboetes	Specific_Term
strafrechtelijke instrumenten	Common_Term
strafrechtelijke onderzoeken	Common_Term
strafrechtelijke procedures	Specific_Term
strafrechtelijke rechtshandhaving	Specific_Term
strafrechtelijke sanctie	Common_Term
strafrechtelijke sancties	Common_Term
strafrechtelijke verantwoordelijkheid	Specific_Term
strafrechtelijke vervolging	Common_Term
strafrechtelijke vervolgingen	Common_Term
strafrechtelijke zaken	Common_Term
strafrechtskader	Specific_Term
strafvervolging	Common_Term
strafvorderingen	Specific_Term
strafwetboek	Common_Term
strafzaken	Common_Term
strijd tegen corruptie	Common_Term
strijd tegen de corruptie	Common_Term
strijd tegen fraude	Common_Term
subsidie	Common_Term
subsidies	Common_Term
subsidies voor acties	Specific_Term
subsidiewetgeving	Common_Term
subsidiëring	Common_Term
systemen tot voorkoming van witwassen	Common_Term
tactloze	Specific_Term
te goeder trouw	Specific_Term
team voor inspecties ter plaatse	Specific_Term
teams voor inspectie ter plaatse	Specific_Term
teams voor inspecties ter plaatse	Specific_Term
tegenwaarden	Specific_Term
tenuitvoerlegging	Specific_Term
terug te eisen	Common_Term
terughaling van activa	Specific_Term
toezicht van de rechter	Specific_Term
toezichtmechanisme	Common_Term
toezichtsinstrument	Common_Term
toezichtsmechanisme	Common_Term
toezichtsmechanismen	Common_Term
toezichtsvoorschriften	Common_Term
transactiekosten	Common_Term
transacties	Common_Term
transparante	Common_Term
transparanter	Common_Term
transparantie	Common_Term
transversale elementen	Specific_Term
tuchtrechtelijke	Common_Term
tuchtrechtelijke aanpak	Common_Term
tuchtrechtelijke instanties	Common_Term
tuchtrechtelijke sancties	Common_Term
tuchtregels	Common_Term
tussenpersonen	Common_Term
uitbuiting	Common_Term
uitgaven	Common_Term
uitlevering	Common_Term
uitlokker	Specific_Term
uitlokking	Common_Term
uitsluitingsgronden	Specific_Term
vakbond	Common_Term
vakorganisatie	Common_Term
vennootschap	Common_Term
vennootschappen	Common_Term
verantwoordingsplicht	Common_Term
verbeurdverklaren	Specific_Term
verbeurdverklaring	Common_Term
verbeurdverklaring van winst uit corruptie	Common_Term
verblijfkosten	Common_Term
verbreken van het contract	Common_Term
verduisteren	Common_Term
verduistering	Specific_Term
vergoeding	Common_Term
vergoeding van schade	Common_Term
vergunning	Common_Term
vergunningen	Common_Term
verkiezingen	Common_Term
verkiezingscampagnes	Common_Term
verkiezingsuitgaven	Common_Term
vermogen	Common_Term
vermogensbestanddelen	Specific_Term
veroordeeld	Common_Term
veroordeelde	Common_Term
veroordelen	Common_Term
veroordeling	Common_Term
veroordelingen	Common_Term
verordening	Specific_Term
vertrouwelijk	Common_Term
vertrouwelijke	Common_Term
vertrouwelijke karakter	Common_Term
vertrouwelijkheid	Common_Term
vertrouwensposten	Common_Term
vervalsen	Common_Term
vervolgd	Common_Term
vervolgen	Common_Term
vervolging	Common_Term
vervolgingen	Common_Term
vervolgingsautoriteiten	Common_Term
vervolgingsbeleid	Common_Term
verzwarende omstandigheden	Specific_Term
vonnis	Common_Term
vonnissen	Common_Term
voordeel	Common_Term
voordelen	Common_Term
voorrang van de wet	Specific_Term
voorschriften	Common_Term
vorderingen	Common_Term
vorderingen tot schadevergoeding	Common_Term
vrije handel	Common_Term
vrijhandelsovereenkomsten	Specific_Term
vrijheid van opbod	Specific_Term
vrijheidsbeneming	Common_Term
vrijstelling van rechtsvervolging	Specific_Term
vruchtgebruik	Specific_Term
wanbeheer	Common_Term
wanpraktijken	Common_Term
wederrechtelijk	Specific_Term
wederrechtelijke toe-eigening	Specific_Term
wederzijdse rechtshulp	Specific_Term
wereldeconomie	Common_Term
werkgeversorganisatie	Common_Term
wet	Common_Term
wetgevende	Common_Term
wetgever	Common_Term
wetgeving	Common_Term
wetgeving inzake corruptiebestrijding	Common_Term
wetgevingen	Common_Term
wetgevingsinitiatief	Common_Term
wetgevingsvoorstellen	Common_Term
wetsbepalingen	Common_Term
wetshandhaving	Common_Term
wettelijk	Common_Term
wettelijk kader	Common_Term
wettelijke	Common_Term
wettelijke controle	Specific_Term
wettelijke controles	Specific_Term
wettelijke opdecimes	Specific_Term
wettelijke verplichtingen	Common_Term
wettelijke waarde	Common_Term
wetten	Common_Term
wib	Specific_Term
winsten	Common_Term
witboek	Specific_Term
witte lijst	Common_Term
witwaspraktijken	Common_Term
witwasrichtlijn	Specific_Term
witwassen	Common_Term
witwassen van geld	Common_Term
witwassen van opbrengsten	Common_Term
witwassen van opbrengsten van misdrijven	Common_Term
zakelijke	Common_Term
zakelijke transacties	Common_Term
zakenbelangen	Common_Term
zakencontacten	Common_Term
zakenleven	Common_Term
zakenwereld	Common_Term
zelfreguleringssystemen	Specific_Term
zelfreinigende	Specific_Term
zetelovereenkomst	Specific_Term
zittingsperiode	Common_Term
zwarte lijst	Common_Term
zwarte lijsten	Common_Term
