24-uurstonometrisch	Specific_Term
5fu	Specific_Term
6-minutenlooptest	Specific_Term
95-betrouwbaarheidsinterval	OOD_Term
a. carotis	Specific_Term
aandoening	Common_Term
aandoeningen	Common_Term
aangeboren	Common_Term
aanpak van hartfalen	Named_Entity
abdomen	Specific_Term
abdominale	Specific_Term
academisch medisch centrum	Named_Entity
accidentele celdood	Specific_Term
ace	Specific_Term
ace-inhibitoren	Specific_Term
ace-remmer	Specific_Term
ace-remmergebruikers	Specific_Term
ace-remmers	Specific_Term
ace-remmertherapie	Specific_Term
ace-remming	Specific_Term
acenocoumarol	Specific_Term
acetylsalicylaat	Specific_Term
acetylsalicylzuur	Specific_Term
acetylsalicylzuurgebruik	Specific_Term
acidose	Specific_Term
acra	Specific_Term
acs	Specific_Term
acute	Common_Term
acute bronchitis	Common_Term
acute coronaire syndromen	Specific_Term
acute dyspneu	Specific_Term
acute dyspnoe	Specific_Term
acute hartfalen	Common_Term
acute myocardinfarcten	Specific_Term
acute nierinsufficiëntie	Specific_Term
acuut	Common_Term
acuut coronair syndroom	Specific_Term
acuut hartfalen	Common_Term
acuut myocardinfarct	Specific_Term
ademgeruis	Common_Term
adenosine	Specific_Term
adenosine-di-fosfaat	Specific_Term
adipositas	Specific_Term
adjuvant	Specific_Term
adjuvante	Specific_Term
adjuvante systeemtherapie	Specific_Term
adp	Specific_Term
adrenaline	Common_Term
adrenerge	Specific_Term
adrenomedulline	Specific_Term
agarose-gel-elektroforese	Specific_Term
aii-antagonist	Specific_Term
aii-antagonisten	Specific_Term
alat	Specific_Term
aldosteron	Specific_Term
aldosteronantagonist	Specific_Term
aldosteronantagonisten	Specific_Term
aldosterone-antagonist	Specific_Term
aldosteronproductie	Specific_Term
aldosteronreceptorantagonist	Specific_Term
aldosteronreceptorblokker	Specific_Term
aldosteronreceptoren	Specific_Term
aldosteronsecretie	Specific_Term
aldosteronspiegel	Specific_Term
aliskiren	Specific_Term
allel	Specific_Term
allelen	Specific_Term
allelfrequentie	Specific_Term
allhat	Named_Entity
alogliptine	Specific_Term
alogliptinebehandelde	Specific_Term
als	Specific_Term
ambulant	Specific_Term
ambulante	Specific_Term
american college of cardiology	Named_Entity
american heart association	Named_Entity
american thoracic society	Named_Entity
amiloride	Specific_Term
amiodaron	Specific_Term
amlodipine	Specific_Term
amsterdam	Named_Entity
anaesthetica	Specific_Term
anamnese	Specific_Term
anemie	Specific_Term
angina	Specific_Term
angina pectoris	Specific_Term
angineuze	Specific_Term
angio-oedeem	Specific_Term
angioneurotisch oedeem	Specific_Term
angiotensine	Specific_Term
angiotensine converterende enzymremmers	Specific_Term
angiotensine converting enzyme	Specific_Term
angiotensine converting enzyme remmers	Specific_Term
angiotensine ii	Specific_Term
angiotensine ii-receptorblokkers	Specific_Term
angiotensine receptor neprilysine inhibitors	Specific_Term
angiotensine receptorblokkers	Specific_Term
angiotensine-'converting'-enzymremmers	Specific_Term
angiotensine-2-receptorblokker	Specific_Term
angiotensine-converterend-enzym	Specific_Term
angiotensine-converterend-enzymremmers	Specific_Term
angiotensine-i	Specific_Term
angiotensine-ii	Specific_Term
angiotensine-ii receptor blokkers	Specific_Term
angiotensine-ii-antagonist	Specific_Term
angiotensine-ii-antagonisten	Specific_Term
angiotensine-ii-receptorantagonist	Specific_Term
angiotensine-ii-receptorblocker	Specific_Term
angiotensine-ii-receptorblockers	Specific_Term
angiotensine-ii-receptorblokker	Specific_Term
angiotensine-ii-receptorblokkers	Specific_Term
angiotensine-receptor-blokkers	Specific_Term
angiotensine-receptorantagonisten	Specific_Term
angiotensineconverterend enzym	Specific_Term
angiotensineconverterend-enzym	Specific_Term
angiotensineconverterendenzymremmers	Specific_Term
angiotensinereceptorblokkers	Specific_Term
angiotensinogeen	Specific_Term
angulus sterni	Specific_Term
annals of internal medicine	Named_Entity
anp	Specific_Term
antagoneren	Specific_Term
antagonist	Specific_Term
antagonisten	Specific_Term
anterolateraal myocardinfarct	Specific_Term
anti-inflammatoir	Specific_Term
anti-inflammatoire	Specific_Term
antiaritmica	Specific_Term
antiaritmicum	Specific_Term
antiarrhythmica	Specific_Term
antibiotica	Common_Term
antibioticagebruik	Common_Term
antibioticavoorschriften	Common_Term
anticoagulantia	Specific_Term
antidiabetische	Common_Term
antidiuretisch hormoon	Specific_Term
antihypertensieve behandeling	Specific_Term
antihypertensiva	Specific_Term
antihypertensivum	Specific_Term
antioxidantia	Specific_Term
antitumoreffect	Specific_Term
antracyclinechemotherapie	Specific_Term
antracyclinederivaten	Specific_Term
antracyclinegebruik	Specific_Term
antracyclinen	Specific_Term
anxiolytica	Specific_Term
aortadruk	Specific_Term
aortaklepstenose	Specific_Term
aortale	Specific_Term
aortastenose	Specific_Term
apex	Specific_Term
apoptose	Specific_Term
apoptosis	Specific_Term
apoptotische	Specific_Term
apoptotische cellen	Specific_Term
arb's	Specific_Term
arbs	Specific_Term
archives of internal medicine	Named_Entity
arg389	Specific_Term
arg389-variant	Specific_Term
arg389-variantcellen	Specific_Term
arginine	Specific_Term
aritmie	Specific_Term
aritmieën	Specific_Term
arni's	Specific_Term
arterieel	Specific_Term
arteriole	Specific_Term
arterioveneuze	Specific_Term
arteriële	Specific_Term
arteriële bloeddruk	Specific_Term
arteriële bloedgasanalyse	Specific_Term
arteriële bloedgaswaarden	Specific_Term
arteriële perfusie	Specific_Term
arteriële stijfheid	Specific_Term
arteriële systeem	Specific_Term
artritis	Common_Term
arts	Common_Term
artsen	Common_Term
asat	Specific_Term
ascend	Named_Entity
ascites	Specific_Term
ascitesvocht	Specific_Term
aspecifieke intraventriculaire geleidingsvertraging	Specific_Term
aspirine	Common_Term
assent-4	Named_Entity
asthma cardiale	Specific_Term
astma	Common_Term
astmapatiënten	Common_Term
asymptomatisch	Common_Term
asymptomatische	Common_Term
at ii	Specific_Term
at-ii-antagonist	Specific_Term
at-ii-receptorantagonisten	Specific_Term
at1	Specific_Term
at1-receptor	Specific_Term
aterogenese	Specific_Term
athene	Named_Entity
atherogenese	Specific_Term
atherosclerotische aandoeningen	Specific_Term
atherosclerotische ziekten	Specific_Term
atrioventriculair	Specific_Term
atrioventriculair blok	Specific_Term
atrioventriculaire	Specific_Term
atrioventriculaire koppeling	Specific_Term
atrium	Specific_Term
atriumfibrillatie	Specific_Term
atriumfibrilleren	Specific_Term
atriumgrootte	Specific_Term
atriumnatriuretische	Specific_Term
atriumpeptiden	Specific_Term
auc	OOD_Term
auscultatie	Specific_Term
av-blok	Specific_Term
axial flow pump	Specific_Term
b-type natriuretisch peptide	Specific_Term
b-type natriuretische peptiden	Specific_Term
b-type peptiden	Specific_Term
b-type-natriuretisch peptide	Specific_Term
b-type-natriuretische peptiden	Specific_Term
b-typenatriuretisch peptide	Specific_Term
backward failure	Specific_Term
baseline	Specific_Term
basenoverschot	Specific_Term
basisartsen	Common_Term
basisreanimatie	Specific_Term
basistherapie	Common_Term
batista	Named_Entity
batista-operatie	Specific_Term
batista-procedure	Specific_Term
bax	Specific_Term
bcl2	Specific_Term
be	Specific_Term
beenmerg	Common_Term
behandelverpleegkundige	Specific_Term
behoefte seksuele voorlichting schaal-chf	Named_Entity
behouden ejectiefractie	Specific_Term
belgië	Named_Entity
benauwdheid	Common_Term
benzbromaron	Specific_Term
beroerte	Common_Term
beroertes	Common_Term
beta-agonist	Specific_Term
beta-blokkers	Specific_Term
beta-gonisten	Specific_Term
betablokker	Specific_Term
betablokkers	Specific_Term
bi	OOD_Term
bi ventricular assist device	Specific_Term
bicarbonaat	Specific_Term
bijnier	Common_Term
bijwerking	Common_Term
bijwerkingen	Common_Term
bijwerkingenprofiel	Specific_Term
bilirubinewaarde	Specific_Term
biomarker	Specific_Term
biomarkers	Specific_Term
biomedische	Common_Term
bisoprolol	Specific_Term
bivad	Specific_Term
biventriculaire	Specific_Term
biventriculaire kamerstimulatie	Specific_Term
biventriculaire stimulator	Specific_Term
bloed	Common_Term
bloedbeeld	Specific_Term
bloeddruk	Common_Term
bloeddrukdaling	Common_Term
bloeddrukmeting	Common_Term
bloeddrukverlagende medicatie	Common_Term
bloeddrukverlagende middelen	Common_Term
bloeddrukverlaging	Common_Term
bloeddrukwaarde	Common_Term
bloedgasanalyse	Specific_Term
bloedgaswaarden	Specific_Term
bloedige	Specific_Term
bloedige drukmeting	Specific_Term
bloedige meting	Specific_Term
bloedige metingen	Specific_Term
bloeding	Common_Term
bloedingen	Common_Term
bloedingsrisico's	Specific_Term
bloedingstijd	Specific_Term
bloedonderzoek	Common_Term
bloedplaatjes	Common_Term
bloedtoevoer	Common_Term
bloedvat	Common_Term
bloedvaten	Common_Term
bmi	Common_Term
bnp	Specific_Term
bnp-bepaling	Specific_Term
bnp-plasmaspiegels	Specific_Term
body mass index	Common_Term
body-mass index	Common_Term
boezemfibrilleren	Specific_Term
bolus	Specific_Term
bolustoediening	Specific_Term
borst	Common_Term
borstkanker	Common_Term
bovenbuikklachten	Common_Term
bradyaritmieën	Specific_Term
bradycardie	Specific_Term
bradycardieën	Specific_Term
bradykinine	Specific_Term
brazilië	Named_Entity
breed qrs-complex	Specific_Term
breinnatriuretisch peptide	Specific_Term
british medical journal	Named_Entity
bronchitis	Common_Term
bronchoconstrictie	Specific_Term
bronchospasme	Specific_Term
brügemann	Named_Entity
bsvs-chf	Named_Entity
bucindolol	Specific_Term
buikklachten	Common_Term
buikpijn	Common_Term
buikpijnklachten	Common_Term
bumetanide	Specific_Term
bundeltakblokpatroon	Specific_Term
bypassoperatie	Common_Term
bèta-2- agonisten	Specific_Term
bèta-2-adrenoceptor	Specific_Term
bèta-2-adrenoceptoren	Specific_Term
bèta-adrenerge receptoren	Specific_Term
bèta-adrenoceptorblokkade	Specific_Term
bèta-adrenoceptorblokker	Specific_Term
bèta-blokkers	Specific_Term
bètablokkeerder	Specific_Term
bètablokkeerders	Specific_Term
bètablokker	Specific_Term
bètablokkers	Specific_Term
bètareceptorantagonisten	Specific_Term
bètareceptorblokkade	Specific_Term
c-statistic	OOD_Term
c-statistiek	OOD_Term
cabg	Specific_Term
cachexie	Specific_Term
calciumantagonist	Specific_Term
calciumantagonisten	Specific_Term
calciuminflux	Specific_Term
calciumkanaalblokkers	Specific_Term
calciuretisch	Specific_Term
canada	Named_Entity
candesartan	Specific_Term
candesartan in heart failure: assessment of reduction in mortality and morbidity	Named_Entity
candesartangroep	Specific_Term
capecitabine	Specific_Term
capecitabinebehandeling	Specific_Term
capecitabinedosis	Specific_Term
captopril	Specific_Term
captoprilgebruik	Specific_Term
captoprilgebruikers	Specific_Term
captoprilgroep	Specific_Term
carcinoom	Specific_Term
cardiaal	Common_Term
cardiac index	Specific_Term
cardiac insufficiency bisoprolol study	Named_Entity
cardiac output	Specific_Term
cardiale	Common_Term
cardiale functie	Common_Term
cardiale insufficiëntie	Specific_Term
cardiale ischemie	Specific_Term
cardiale myocyt	Specific_Term
cardiale pompfunctie	Specific_Term
cardiale resynchronisatietherapie	Specific_Term
cardiale schade	Specific_Term
cardiale-resynchronisatietherapie	Specific_Term
cardiochirurgie	Common_Term
cardiogene	Specific_Term
cardiogene shock	Specific_Term
cardiologen	Common_Term
cardiologenpanel	Common_Term
cardiologie	Common_Term
cardiologische	Common_Term
cardiologische polikliniek	Common_Term
cardioloog	Common_Term
cardiomegalie	Specific_Term
cardiomyocyt	Specific_Term
cardiomyocytdiameter	Specific_Term
cardiomyocyten	Specific_Term
cardiomyocytkernen	Specific_Term
cardiomyopathie	Specific_Term
cardiomyopathieën	Specific_Term
cardiomyoplastiek	Specific_Term
cardiopulmonale	Specific_Term
cardiopulmonale resuscitatie	Specific_Term
cardioselectieve bètablokker	Specific_Term
cardioselectieve bètablokkers	Specific_Term
cardiothoracale ratio	Specific_Term
cardiotoxiciteit	Specific_Term
cardiovasculair	Specific_Term
cardiovasculaire	Specific_Term
cardiovasculaire aandoeningen	Specific_Term
cardiovasculaire morbiditeit	Specific_Term
cardiovasculaire mortaliteit	Specific_Term
cardiovasculaire sterfte	Specific_Term
cardiovasculaire ziekte	Specific_Term
cardiovasculaire ziekten	Specific_Term
carmen	Named_Entity
carotispols	Specific_Term
carvedilol	Specific_Term
carvedilol and ace-inhibitor remodeling in mild heart failure evaluation	Named_Entity
carvedilol hibernation reversible ischaemia trial; marker of success	Named_Entity
carvedilol or metoprolol european trial	Named_Entity
carvedilolgroep	Specific_Term
casussen	Specific_Term
casuïstiek	Specific_Term
casuïstische	Specific_Term
cavum douglasi	Specific_Term
celdood	Specific_Term
celkweek	Specific_Term
cellulaire groei	Specific_Term
cellulaire toxiciteit	Specific_Term
centraal veneuze druk	Specific_Term
centraalveneuze druk	Specific_Term
cerebrale	Specific_Term
cerebrale doorbloeding	Specific_Term
cerebrovasculair accident	Specific_Term
cerebrovasculaire	Specific_Term
chae	Named_Entity
charm	Named_Entity
charm-added	Named_Entity
charm-alternative	Named_Entity
charm-onderzoek	Named_Entity
charm-preserved	Named_Entity
charmalternative	Named_Entity
chemotherapeutische	Specific_Term
chemotherapie	Common_Term
chf	Common_Term
chirurgie	Common_Term
chirurgische	Common_Term
chloorhexidine	Specific_Term
chloortalidon	Specific_Term
cholecystitis	Specific_Term
cholesterol	Common_Term
cholesterolsyntheseremmer	Specific_Term
cholesterolverlager	Common_Term
cholesterolverlagers	Common_Term
cholesterolverlaging	Common_Term
cholesterolwaarde	Common_Term
christmas	Named_Entity
chromatine	Specific_Term
chronisch	Common_Term
chronisch harfalen	Common_Term
chronisch hartfalen	Common_Term
chronisch obstructief longlijden	Specific_Term
chronisch obstructieve longziekte	Specific_Term
chronisch systolisch hartfalen	Specific_Term
chronische	Common_Term
chronische bronchitis	Common_Term
chronische dialysetherapie	Specific_Term
chronische hartfalen	Common_Term
chronische nierinsufficiëntie	Specific_Term
chronische nierschade	Specific_Term
chronische ziekte	Common_Term
chronotroop	Specific_Term
chz	Specific_Term
cibis iii	Named_Entity
cimetidine	Specific_Term
circulatie	Common_Term
circulation	Named_Entity
classificatie van de new york heart association	Specific_Term
claudicatio	Specific_Term
clinicus	Common_Term
clopidogrel	Specific_Term
clopidogreltherapie	Specific_Term
cns	Specific_Term
co2-retentie	Specific_Term
coach	Named_Entity
cochrane	Named_Entity
cochrane library	Named_Entity
coenzym q10	Specific_Term
cohn	Named_Entity
cohortonderzoek	OOD_Term
collaps	Specific_Term
collapsneiging	Specific_Term
collapspunt	Specific_Term
colonoscopie	Specific_Term
colorectaal carcinoom	Specific_Term
combinatietherapie	Specific_Term
comedicatie	Specific_Term
comet	Named_Entity
comorbiditeit	Specific_Term
comorbiditeiten	Specific_Term
compliance	Specific_Term
compliantie	Specific_Term
complicatie	Common_Term
complicaties	Common_Term
confocale microscopie	Specific_Term
congenitale	Specific_Term
congestief hartfalen	Specific_Term
consensus	Named_Entity
constructvaliditeit	Specific_Term
consultatie	Common_Term
contractie	Specific_Term
contractiele	Specific_Term
contractieverloop	Specific_Term
contractiliteit	Specific_Term
controleharten	Specific_Term
cooperative north scandinavian publication enalapril survival study	Named_Entity
coordinating study evaluating outcomes of advising and counseling in heartfailure	Named_Entity
copd	Specific_Term
copd met secundaire rechtszijdige belasting	Specific_Term
copd-exacerbatie	Specific_Term
copd-exacerbaties	Specific_Term
copernicus	Named_Entity
cor-thoraxratio	Specific_Term
coronair	Specific_Term
coronairaandoeningen	Specific_Term
coronairangiografie	Specific_Term
coronaire	Specific_Term
coronaire bypass	Specific_Term
coronaire bypassoperatie	Specific_Term
coronaire hartziekte	Specific_Term
coronaire hartziekten	Specific_Term
coronaire revascularisatie	Specific_Term
coronaire vaten	Specific_Term
coronaire ziekte	Specific_Term
coronairlijden	Specific_Term
coronairvaten	Specific_Term
coronairziekte	Specific_Term
coronarialijden	Specific_Term
correlatie	OOD_Term
corticosteroïden	Specific_Term
costofrenische sinus	Specific_Term
coumarine	Specific_Term
coumarinegroep	Specific_Term
coumarines	Specific_Term
cowie	Named_Entity
cox	Specific_Term
cox 1-remmers	Specific_Term
cox 2-remmers	Specific_Term
cox' regressieanalyse	OOD_Term
cox-2-remmers	Specific_Term
creatineklaring	Specific_Term
creatinine	Specific_Term
creatinineconcentratie	Specific_Term
creatinineklaring	Specific_Term
creatininewaarden	Specific_Term
crepitaties	Specific_Term
crepiteren	Specific_Term
criteriumvaliditeit	OOD_Term
criticalcare-afdelingen	Common_Term
cross-over onderzoek	OOD_Term
cross-overonderzoek	OOD_Term
cross-sectioneel onderzoek	OOD_Term
crp	Specific_Term
crt	Specific_Term
crt-d	Specific_Term
ct	Specific_Term
cumarinen	Specific_Term
cumarines	Specific_Term
cv	Specific_Term
cv aandoeningen	Specific_Term
cv events	Specific_Term
cva	Specific_Term
cva's	Specific_Term
cvd	Specific_Term
cvd's	Specific_Term
cvz	Specific_Term
cyclo-oxygenase	Specific_Term
cyp2c9	Specific_Term
cytochroom	Specific_Term
cytokinen	Specific_Term
cytostatica	Specific_Term
cytostaticum	Specific_Term
cytotoxisch	Specific_Term
cytotoxische	Specific_Term
cytotoxische metabolieten	Specific_Term
darmischemie	Specific_Term
darmpakket	Specific_Term
darmwand	Specific_Term
decapeptide	Specific_Term
decompensatie	Specific_Term
decompensatio cordis	Specific_Term
defibrillatie	Common_Term
defibrillator	Common_Term
defibrillatortherapie	Specific_Term
defibrilleren	Common_Term
dehydratie	Specific_Term
derde harttoon	Specific_Term
derdegraads atrioventriculair blok	Specific_Term
derdegraads av-blok	Specific_Term
diabetes	Common_Term
diabetes mellitus	Specific_Term
diabetes mellitus type 2	Specific_Term
diabetes type-2	Specific_Term
diabetesbehandeling	Common_Term
diabetespatiënten	Common_Term
diabeteszorgprogamma's	Common_Term
diabetische	Common_Term
diabetische cardiomyopathie	Specific_Term
diabetische maculopathie	Specific_Term
diafragma	Specific_Term
diagnose	Common_Term
diagnosen	Common_Term
diagnoses	Common_Term
diagnosticeren	Common_Term
diagnosticum	Specific_Term
diagnostiek	Common_Term
diagnostisch	Common_Term
diagnostische	Common_Term
dialysetherapie	Specific_Term
diastolisch	Specific_Term
diastolisch hartfalen	Specific_Term
diastolische	Specific_Term
diastolische bloeddruk	Specific_Term
diastolische disfunctie	Specific_Term
diastolische druk	Specific_Term
diastolische functie	Specific_Term
diastolische linkerventrikeldisfunctie	Specific_Term
diclofenac	Specific_Term
differentiaaldiagnose	Specific_Term
diffuse ischemie	Specific_Term
diffuus intrarenale vaatafwijkingen	Specific_Term
diffuus reticulaire versterking van de longvaattekening	Specific_Term
dig	Named_Entity
digitalis	Specific_Term
digitalis investigation group	Named_Entity
digitalisintoxicatie	Specific_Term
digitalispreparaten	Specific_Term
digotoxine	Specific_Term
digoxine	Specific_Term
digoxine-intoxicatie	Specific_Term
digoxine-spiegels	Specific_Term
digoxinebepaling	Specific_Term
digoxineconcentratiespiegel	Specific_Term
digoxinegebruik	Specific_Term
digoxinespiegel	Specific_Term
digoxinespiegels	Specific_Term
dihydropyridines	Specific_Term
dihydropyrimidinedehydrogenase	Specific_Term
dilatatie	Specific_Term
dilatatie van de linker ventrikel	Specific_Term
dilatatie van de lv	Specific_Term
dilatatie van de ventrikel	Specific_Term
dilatatoire	Specific_Term
dilatatoire cardiomyopathie	Specific_Term
dilaterende	Specific_Term
dilaterende cardiomyopathie	Specific_Term
diltiazem	Specific_Term
discriminerend vermogen	OOD_Term
disfunctie	Common_Term
diurese	Specific_Term
diuretica	Specific_Term
diureticabeleid	Specific_Term
diureticadoseringen	Specific_Term
diureticadosis	Specific_Term
diureticagebruik	Specific_Term
diureticagebruikers	Specific_Term
diureticaresistentie	Specific_Term
diureticatoediening	Specific_Term
diureticum	Specific_Term
diureticumdosis	Specific_Term
diuretisch	Specific_Term
diuretische	Specific_Term
dm	Specific_Term
dm2	Specific_Term
dna	Common_Term
dna-fragmentatie	Specific_Term
dobutamine	Specific_Term
dobutaminetherapie	Specific_Term
dobutaminethuisinfusie	Specific_Term
dokter	Common_Term
dokters	Common_Term
domperidon	Specific_Term
donoren	Common_Term
donorhart	Common_Term
donororganen	Common_Term
doorbloeding	Common_Term
dosisoptitratie	Specific_Term
dosisresponsrelatie	Specific_Term
dossieronderzoek	OOD_Term
dotterbehandeling	Specific_Term
downregulatie	Specific_Term
doxazosine	Specific_Term
dpp-4	Specific_Term
dpp-4 remmers	Specific_Term
dpp-iv	Specific_Term
dpp-iv-remmers	Specific_Term
dpp4	Specific_Term
dpp4-remming	Specific_Term
druk-volumerelaties	Specific_Term
drukbelasting	Common_Term
drukpijn	Specific_Term
dubbelblind	OOD_Term
dubbelblinde	OOD_Term
duitsland	Named_Entity
dutp	Specific_Term
dysfunctie	Common_Term
dysfunctie van de linker ventrikel	Specific_Term
dyslipedemie	Specific_Term
dyspneu	Specific_Term
dyspnoe	Specific_Term
dyspnoïsch	Specific_Term
dyspnoïsche	Specific_Term
dyspnée	Specific_Term
dyspnée d'effort	Specific_Term
east boston senior health project	Named_Entity
eccles	Named_Entity
ecg	Specific_Term
echo	Common_Term
echocardiografie	Specific_Term
echocardiografisch	Specific_Term
echocardiografische	Specific_Term
echocardiogram	Specific_Term
echografie	Common_Term
echografisch	Common_Term
echotechniek	Specific_Term
eerste hulp	Common_Term
eerstehulpafdeling	Common_Term
eerstelijnsbehandeling	Common_Term
eerstelijnsgezondheidszorg	Common_Term
effectief circulerend volume	Specific_Term
efferente arteriole	Specific_Term
ehs-hf	Named_Entity
einddiastolische	Specific_Term
einddiastolische linkerventrikelvolume	Specific_Term
einddoeltherapie	Specific_Term
einddoeltherapiepatiënten	Specific_Term
eindpunt	Specific_Term
eindpunten	Specific_Term
eindstadium hartfalen	Specific_Term
eindstadiumhartfalen	Specific_Term
eindsystolische	Specific_Term
eindsystolische linkerventrikeldruk	Specific_Term
eindsystolische lv-diameter	Specific_Term
eiwit	Common_Term
ejectiefractie	Specific_Term
ejectiefractie van het linker ventrikel	Specific_Term
elektrische asynchronie	Specific_Term
elektrocardiografie	Specific_Term
elektrocardiografisch	Specific_Term
elektroforese	Specific_Term
elektrofysiologische	Specific_Term
elektrolyten	Specific_Term
elektrolytstoornissen	Specific_Term
elektronische patiëntendossiers	Specific_Term
elite	Named_Entity
embase	Named_Entity
embolische	Specific_Term
emea	Named_Entity
emma kinderziekenhuis	Named_Entity
empa-reg outcome	Named_Entity
enalapril	Specific_Term
endomyocardfibrose	Specific_Term
endotheelfunctie	Specific_Term
endotheline	Specific_Term
enkeloedeem	Specific_Term
enkelvoudige nucleotidepolymorfisme	Specific_Term
enzym	Specific_Term
enzymwerking	Specific_Term
eosine	Specific_Term
epd's	Specific_Term
epicardiale vene	Specific_Term
epidemiologie	Specific_Term
epidemiologisch	Specific_Term
epidemiologische	Specific_Term
epifenomenen	Specific_Term
eplerenon	Specific_Term
erfelijke	Common_Term
ergometrietest	Specific_Term
ernstig hartfalen	Specific_Term
esc	Named_Entity
etiologie	Specific_Term
etiologisch	Specific_Term
euro heart survey on heart failure	Named_Entity
europa	Named_Entity
european resuscitation council	Named_Entity
european society of cardiology	Named_Entity
european trial on reduction of cardiac events with perindopril in stable coronary artery disease	Named_Entity
europese sociëteit voor cardiologie	Named_Entity
euthanasie	Common_Term
euvolemie	Specific_Term
euvolemische	Specific_Term
evaluation of losartan in the elderly	Named_Entity
evidence-based	Specific_Term
evidence-based medicine	Specific_Term
evidencebased	Specific_Term
exacerbatie	Specific_Term
exacerbaties	Specific_Term
exacerberen	Specific_Term
exacerberend	Specific_Term
examine	Named_Entity
excavatio rectouterina	Specific_Term
expressie	Specific_Term
factoranalyse	OOD_Term
familieanamnese	Specific_Term
farmaceutische	Common_Term
farmacodynamiek	Specific_Term
farmacodynamische	Specific_Term
farmacogenetica	Specific_Term
farmacogenetisch	Specific_Term
farmacokinetiek	Specific_Term
farmacokinetische	Specific_Term
farmacologie	Specific_Term
farmacotherapie	Specific_Term
fda	Named_Entity
fdh	Specific_Term
ferritinewaarde	Specific_Term
fev 1	Specific_Term
fev1	Specific_Term
fibrinogeen	Specific_Term
fibrinolytica	Specific_Term
fibrinolytische	Specific_Term
fibroblasten	Specific_Term
fibrose	Specific_Term
fibrose van het myocard	Specific_Term
fietsergometer	Specific_Term
fietsergometertest	Specific_Term
filtratieoppervlak	Specific_Term
filtratiesnelheid	Specific_Term
first dose hypotension	Specific_Term
flecaïnide	Specific_Term
fluorescent resonance energy transfer	Named_Entity
fluoropyrimidine	Specific_Term
fluorouracil	Specific_Term
fluorouracil-prodrugs	Specific_Term
follow-up	Common_Term
follow-upduur	Common_Term
follow-uponderzoek	Common_Term
follow-upperiode	Common_Term
follow-upprogramma's	Common_Term
forward failure	Specific_Term
framingham	Named_Entity
framingham heart study	Named_Entity
framingham offspring study	Named_Entity
fret	Named_Entity
functionele capaciteit	Specific_Term
functionele klasse	Specific_Term
functionele klasse ii	Specific_Term
furosemide	Specific_Term
fysiologische	Common_Term
fysiotherapeut	Common_Term
fysisch-diagnostisch onderzoek	Specific_Term
galblaas	Common_Term
galopritme	Specific_Term
galwegen	Common_Term
gamma-gt	Specific_Term
gastro-enteritis	Specific_Term
gastroscopie	Specific_Term
gecompenseerd hartfalen	Specific_Term
gedaalde ejectiefractie	Specific_Term
gedecompenseerd chronisch hartfalen	Specific_Term
gedecompenseerd hartfalen	Specific_Term
gediagnosticeerd	Common_Term
gedialyseerd	Specific_Term
gedilateerd	Specific_Term
gedilateerde cardiomyopathie	Specific_Term
gelegenheidssteekproef	OOD_Term
geleidingssnelheid	Specific_Term
geleidingsstoornis	Specific_Term
geleidingsstoornissen	Specific_Term
gemetastaseerde gastro-intestinale tumoren	Specific_Term
gen	Common_Term
geneeskunde	Common_Term
geneeskundig	Common_Term
geneeskundige	Common_Term
geneesmidddelen	Common_Term
geneesmiddel	Common_Term
geneesmiddeleffecten	Common_Term
geneesmiddelen	Common_Term
geneesmiddelen bulletin	Named_Entity
geneesmiddeleninteractie	Common_Term
geneesmiddelkosten	Common_Term
geneesmiddellen	Common_Term
geneesmiddelonderzoeken	Common_Term
geneesmiddelvoorschriften	Common_Term
genen	Common_Term
genetisch	Common_Term
genetische	Common_Term
genetische ontrafeling	Specific_Term
genetische polymorfisme	Specific_Term
genotype	Specific_Term
genotype-onafhankelijke antagonist	Specific_Term
gepreserveerde ejectiefractie	Specific_Term
geprogrammeerde celdood	Specific_Term
geprotocolleerde klinische studies	OOD_Term
gerandomiseerd	OOD_Term
gerandomiseerde	OOD_Term
gereanimeerd	Common_Term
gestabiliseerd functioneel hartfalen	Specific_Term
gestratificeerd	Specific_Term
gestructureerde telefonische ondersteuning	Specific_Term
gestuwde halsvenen	Specific_Term
gestuwde lever	Specific_Term
gevoelsstoornissen	Specific_Term
gewogen gemiddelde verschil	OOD_Term
gezonde	Common_Term
gezondheidsvaardigheden	Common_Term
gezondheidsvaardigheid	Common_Term
gezondheidszorginstanties	Common_Term
gezondheidszorgsysteem	Common_Term
gezondheidszorgvoorzieningen	Common_Term
geïmplanteerd	Common_Term
geïsoleerd diastolisch hartfalen	Specific_Term
geïsoleerd rechtszijdig hartfalen	Specific_Term
gfr	Specific_Term
gissi-he	Named_Entity
glad spierweefsel	Specific_Term
gladde spiercellen	Specific_Term
glitazones	Specific_Term
global initiative for copd	Named_Entity
glomerulaire filtratierate	Specific_Term
glomerulaire filtratiesnelheid	Specific_Term
glomerulaire perfusiedruk	Specific_Term
glomerulusfiltratie	Specific_Term
glp-1-analogen	Specific_Term
glucose	Common_Term
glucoseverlagende middelen	Specific_Term
glucosurie	Specific_Term
gly389	Specific_Term
gly389-genotype	Specific_Term
gly389-variant	Specific_Term
glycine	Specific_Term
gold	Named_Entity
gottlieb	Named_Entity
gouden standaard	OOD_Term
goudenstandaarddiagnose	OOD_Term
grade 1a	Named_Entity
grade 1b	Named_Entity
grade 1c	Named_Entity
grade 2b	Named_Entity
grade 2c	Named_Entity
granger	Named_Entity
groenewegen	Named_Entity
groningen	Named_Entity
gruppo italiano per lo studio della sopravivenza nell'insufficienza cardiaca	Named_Entity
gso	Specific_Term
gynaecomastie	Specific_Term
haldol	Specific_Term
halfwaardetijd	Specific_Term
hall	Named_Entity
hallberg	Named_Entity
haloperidol	Specific_Term
halsvenen	Specific_Term
hamstrings	Specific_Term
hand-voetsyndroom	Specific_Term
handvenen	Specific_Term
harfalen	Common_Term
harlem	Named_Entity
hart	Common_Term
hart voor mensen	Named_Entity
hart- en vaatziekte	Common_Term
hart- en vaatziekten	Common_Term
hart- en vaatziektes	Common_Term
hartaandoening	Common_Term
hartaanval	Common_Term
hartactie	Specific_Term
hartafwijking	Common_Term
hartafwijkingen	Common_Term
hartcyclus	Specific_Term
hartdood	Specific_Term
harten	Common_Term
hartfalen	Common_Term
hartfalen algemeen	Named_Entity
hartfalen klasse 2	Specific_Term
hartfalen klasse iii	Specific_Term
hartfalen met een behouden ejectiefractie	Specific_Term
hartfalen met gedaalde ejectiefractie	Specific_Term
hartfalen met gepreserveerde ejectiefractie	Specific_Term
hartfalen met systolische linkerventrikeldisfunctie	Specific_Term
hartfalenbehandeling	Common_Term
hartfalenmedicatie	Common_Term
hartfalenonderzoek	Common_Term
hartfalenonderzoeken	Common_Term
hartfalenpatiënt	Common_Term
hartfalenpatiënten	Common_Term
hartfalenpoli's	Common_Term
hartfalenpolikliniek	Common_Term
hartfalenprogramma's	Common_Term
hartfalenspreekuur	Common_Term
hartfalensymptomen	Common_Term
hartfalenteam	Common_Term
hartfalenverpleegkundige	Common_Term
hartfalenverpleegkundigen	Common_Term
hartfalenzorgprogramma's	Common_Term
hartfalers	Common_Term
hartfrequentie	Specific_Term
hartfunctie	Common_Term
hartgeruis	Specific_Term
hartgeruisen	Specific_Term
hartgrootte	Common_Term
hartinfact	Common_Term
hartinfarct	Common_Term
hartkamers	Specific_Term
hartklachten	Common_Term
hartklepaandoening	Specific_Term
hartklepaandoeningen	Specific_Term
hartklepafwijkingen	Specific_Term
hartklepgebreken	Specific_Term
hartkleplijden	Specific_Term
hartklepstenose	Specific_Term
hartmassae	Common_Term
hartminuutvolume	Specific_Term
hartpatiënten	Common_Term
hartpomp	Specific_Term
hartpompen	Specific_Term
hartrevalidatie	Common_Term
hartrevalidatiearts	Specific_Term
hartrevalidatieprogramma	Common_Term
hartritme	Common_Term
hartritmestoornis	Common_Term
hartritmestoornissen	Common_Term
hartschade	Common_Term
hartslag	Common_Term
hartsouffle	Specific_Term
hartspier	Specific_Term
hartspiercelverval	Specific_Term
hartspiervezel	Specific_Term
hartspierweefsel	Specific_Term
hartstichting	Named_Entity
hartstilstand	Common_Term
harttonen	Specific_Term
harttoon	Specific_Term
harttransplantatie	Common_Term
hartvaataandoening	Common_Term
hartziekte	Common_Term
hartziekten	Common_Term
hazardatio	Specific_Term
hazardratio	Specific_Term
hb	Specific_Term
hba1c	Specific_Term
hbo2	Specific_Term
health literacy	Specific_Term
heart outcomes prevention evaluation	Named_Entity
heartmate	Named_Entity
heartmate vented electric system	Named_Entity
hek293-cellen	Specific_Term
hematologische	Specific_Term
hematologische maligniteiten	Specific_Term
hemodialyse	Specific_Term
hemodynamiek	Specific_Term
hemodynamisch	Specific_Term
hemodynamische	Specific_Term
hepatomegalie	Specific_Term
herdin	Named_Entity
herhospitalisaties	Common_Term
heropgenomen	Common_Term
heropname	Common_Term
heropnamen	Common_Term
heropnames	Common_Term
hersenbloeding	Common_Term
herseninfarct	Common_Term
herseninfarcten	Common_Term
hf	Common_Term
hf-pef	Specific_Term
hfbef	Specific_Term
hibernatie	Specific_Term
hibernatie van het myocard	Specific_Term
histologisch	Specific_Term
hnu	Named_Entity
hoge bloeddruk	Common_Term
hope	Named_Entity
hope-the ongoing outcomes	Named_Entity
hope-too	Named_Entity
hopetoo	Named_Entity
hormoon	Common_Term
hospitalisatie	Common_Term
hospitalisatiefrequentie	Common_Term
hospitalisaties	Common_Term
hr	Specific_Term
ht	Specific_Term
huisarts	Common_Term
huisartsartspraktijk	Common_Term
huisartsdiagnose	Common_Term
huisartsen	Common_Term
huisartsen netwerk utrecht	Named_Entity
huisartsenpraktijk	Common_Term
huisartsenpraktijken	Common_Term
huisartsenregistraties	Common_Term
huisartsenzorg	Common_Term
huisartspraktijk	Common_Term
hulpverleners	Common_Term
hulpverlening	Common_Term
hydralazine	Specific_Term
hydrochloorthiazide	Specific_Term
hypercapnie	Specific_Term
hypercholesterolemie	Specific_Term
hyperfiltratie	Specific_Term
hyperglykemie	Specific_Term
hyperkaliëmie	Specific_Term
hyperlipidemie	Specific_Term
hyperosmolaire hyperglykemische ontregeling	Specific_Term
hypertensie	Specific_Term
hypertensiebehandeling	Specific_Term
hypertensief	Specific_Term
hyperthyreoïdie	Specific_Term
hyperuricemie	Specific_Term
hypervolemische hyponatriëmie	Specific_Term
hypoalbuminemie	Specific_Term
hypoglykemie	Specific_Term
hypokaliëmie	Specific_Term
hypomagnesiëmie	Specific_Term
hyponatriëmie	Specific_Term
hypoperfusie	Specific_Term
hypotensie	Specific_Term
hypovolemie	Specific_Term
hypovolemische hyponatriëmie	Specific_Term
hypoxemische	Specific_Term
hypoxie	Specific_Term
ibopamine	Specific_Term
ibuprofen	Specific_Term
icd	Specific_Term
icd-implantatie	Specific_Term
icd-shocks	Specific_Term
icpc	Specific_Term
ictus	Specific_Term
ictus cordis	Specific_Term
idiopathische	Specific_Term
idiopathische dilaterende cardiomyopathie	Specific_Term
ijzergebreksanemie	Specific_Term
immunomodulerend	Specific_Term
immuunhistochemisch	Specific_Term
implantatie	Common_Term
implantatieprocedure	Common_Term
implanteerbare	Common_Term
implanteerbare automatische defibrillator	Specific_Term
implanteerbare cardioverter-defibrillator	Specific_Term
implanteerbare cardioverterende defibrillator	Specific_Term
implanteerbare defibrillator	Specific_Term
implanteerbare hartpompen	Specific_Term
in-vitro	Specific_Term
in-vitro-opstelling	Specific_Term
in-vitrostudie	Specific_Term
incidentie	Specific_Term
indianapolis	Named_Entity
infarct	Common_Term
infectie	Common_Term
infecties	Common_Term
infusie	Common_Term
infusiesysteem	Specific_Term
infusietherapie	Common_Term
inhoudsvaliditeit	OOD_Term
inotroop	Specific_Term
inotrope	Specific_Term
inotropica	Specific_Term
inotropieafhankelijk	Specific_Term
inr	Specific_Term
inspannings-ecg	Specific_Term
inspanningstolerantie	Specific_Term
inspanningsvermogen	Specific_Term
insuline	Common_Term
insulinegevoeligheid	Common_Term
intensieve zorgen	Common_Term
intensive-careafdeling	Specific_Term
intention to treat	Specific_Term
intermediaire hartas	Specific_Term
internist	Common_Term
internisten	Common_Term
internistisch	Common_Term
interstitieel oedeem	Specific_Term
intra-abdominale druk	Specific_Term
intra-aortale ballonpomp	Specific_Term
intracardiale	Specific_Term
intracardiale defibrillator	Specific_Term
intracardiale trombi	Specific_Term
intrarenale	Specific_Term
intrathoracale	Specific_Term
intrathoracale druk	Specific_Term
intrathoracale pathologie	Specific_Term
intravasculair volume	Specific_Term
intraveneus	Specific_Term
intraveneuze	Specific_Term
intraveneuze bolus	Specific_Term
intraveneuze diuretica	Specific_Term
intraveneuze inotropica	Specific_Term
intraveneuze medicatie	Specific_Term
intraveneuze therapie	Specific_Term
intraventriculaire	Specific_Term
intraventriculaire geleidingstijd	Specific_Term
intrinsieke sympathicomimetische activiteit	Specific_Term
invasief	Specific_Term
invasieve	Specific_Term
invasiviteit	Specific_Term
invers agonistisch effect	Specific_Term
inverse agonistische werking	Specific_Term
ion-kanalen	Specific_Term
isa	Specific_Term
ischaemische	Specific_Term
ischaemische beroerte	Specific_Term
ischemie	Specific_Term
ischemisch	Specific_Term
ischemisch hartfalen	Specific_Term
ischemische	Specific_Term
ischemische beroerte	Specific_Term
ischemische cardiomyopathie	Specific_Term
ischemische hartziekte	Specific_Term
ischemische hartziekten	Specific_Term
isosorbidedinitraat	Specific_Term
isosorbidemononitraat	Specific_Term
jejunum	Specific_Term
jicht	Common_Term
journal of negative results in biomedicine	Named_Entity
k	Specific_Term
kalium	Specific_Term
kaliumexcretie	Specific_Term
kaliumrijk	Specific_Term
kaliumsparende diuretica	Specific_Term
kaliumspiegel	Specific_Term
kaliumsupplementen	Specific_Term
kaliumsuppletie	Specific_Term
kaliumuitscheiding	Specific_Term
kamer	Specific_Term
kamerfunctie	Specific_Term
kamers	Specific_Term
kamerstimulatie	Specific_Term
kaplan-meier-methode	OOD_Term
katheterpunt	Specific_Term
kerley-b-lijntjes	Specific_Term
kernsymptomen	Common_Term
ketenzorg	Specific_Term
klasse-i-antiaritmica	Specific_Term
klepafwijking	Specific_Term
klepafwijkingen	Specific_Term
klepdisfunctie	Specific_Term
klepfunctie	Specific_Term
klepgebreken	Specific_Term
kleplijden	Specific_Term
klepoperaties	Specific_Term
kliniek	Common_Term
klinieken	Common_Term
klinisch	Common_Term
klinisch hartfalen	Specific_Term
klinisch manifest hartfalen	Specific_Term
klinische	Common_Term
klink	Named_Entity
kortademigheid	Common_Term
kortademigheidsklachten	Common_Term
kransvatomleidingsoperatie	Specific_Term
kunstharten	Common_Term
kunstklep	Specific_Term
kwaliteit van leven	Common_Term
kwikmanometer	Specific_Term
lactaatacidose	Specific_Term
lactaatconcentratie	Specific_Term
lage bloeddruk	Common_Term
landelijk informatienetwerk huisartsenzorg	Named_Entity
landelijke transmurale afspraak chronische nierschade	Named_Entity
langwerkende nitraten	Specific_Term
laparoscopie	Specific_Term
lcz696	Specific_Term
left ventricular assist device	Specific_Term
letaal	Specific_Term
letale	Specific_Term
leukocyten	Specific_Term
levenskwaliteit	Common_Term
levensverwachting	Common_Term
lever	Common_Term
leverfalen	Common_Term
leverrand	Specific_Term
leverstuwing	Specific_Term
levervenen	Specific_Term
leverziekten	Common_Term
lichamelijk onderzoek	Common_Term
lineaire relatie	OOD_Term
linh	Named_Entity
linker atrium	Specific_Term
linker kamer	Specific_Term
linker ventrikel	Specific_Term
linker ventrikel ondersteunende apparaten	Specific_Term
linker ventrikelfunctie	Specific_Term
linker-ventrikel	Specific_Term
linker-ventrikel-ejectiefractie	Specific_Term
linkerbundeltakblok	Specific_Term
linkerbundeltakblokconfiguratie	Specific_Term
linkerkamerdisfunctie	Specific_Term
linkerventrikel	Specific_Term
linkerventrikel-ejectiefractie	Specific_Term
linkerventrikeldisfunctie	Specific_Term
linkerventrikeldruk	Specific_Term
linkerventrikeldysfunctie	Specific_Term
linkerventrikelejectiefractie	Specific_Term
linkerventrikelfunctie	Specific_Term
linkerventrikelhypertrofie	Specific_Term
linkerventrikelondersteuningspomp	Specific_Term
linkerventrikelvolume	Specific_Term
lipidenprofiel	Specific_Term
lipidenverlagende	Specific_Term
lisdiuretica	Specific_Term
lisdiureticum	Specific_Term
lisdiureticuma	Specific_Term
lisinopril	Specific_Term
lisinopriltoediening	Specific_Term
long	Common_Term
longaandoeningen	Common_Term
longarts	Common_Term
longcapaciteit	Common_Term
longcrepitaties	Specific_Term
longembolie	Specific_Term
longen	Common_Term
longfoto	Common_Term
longfunctieonderzoek	Specific_Term
longmaligniteit	Specific_Term
longoedeem	Specific_Term
longproblemen	Common_Term
longstuwing	Specific_Term
longvaatbed	Specific_Term
longvaattekening	Specific_Term
longvelden	Specific_Term
losartan	Specific_Term
losartangebruikers	Specific_Term
losartangroep	Specific_Term
loslaatpijn	Specific_Term
luchtwegen	Common_Term
luchtwegobstructie	Specific_Term
lv	Specific_Term
lv-diameter	Specific_Term
lv-diameters	Specific_Term
lv-dilatatie	Specific_Term
lv-ejectiefractie	Specific_Term
lv-wandspanning	Specific_Term
lvad	Specific_Term
lvedd	Specific_Term
lvef	Specific_Term
lvesd	Specific_Term
lvsd	Specific_Term
m. iliopsoas	Specific_Term
m. sternocleidomastoideus	Specific_Term
mace	Specific_Term
macroalbuminurie	Specific_Term
magnesium	Specific_Term
magnesiumsupplementen	Specific_Term
maligniteit	Specific_Term
maligniteiten	Specific_Term
mammacarcinoom	Specific_Term
map	Specific_Term
mass.	Named_Entity
massachusetts	Named_Entity
matig hartfalen	Specific_Term
matrixverval	Specific_Term
max rubens	Named_Entity
maximale zuurstofopnamevermogen	Specific_Term
mayo clinic	Named_Entity
mdr	Specific_Term
mean arterial pressure	Specific_Term
mechanische linker ventrikel ondersteunende apparaten	Specific_Term
medicament	Common_Term
medicamenten	Common_Term
medicamenteus	Common_Term
medicamenteuze	Common_Term
medicamenteuze behandeling	Common_Term
medicamenteuze therapie	Common_Term
medicatie	Common_Term
medicatiebeleid	Common_Term
medicatieplan	Common_Term
medicatiestappen	Common_Term
medicijn	Common_Term
medicijnen	Common_Term
medicijngebruik	Common_Term
medicus	Common_Term
medioclaviculaire lijn	Specific_Term
medisch	Common_Term
medische	Common_Term
medline	Named_Entity
melkzuuracidose	Specific_Term
merit-hf	Named_Entity
mesangium	Specific_Term
mesenteriale ischemie	Specific_Term
meta-analyse	OOD_Term
meta-analyses	OOD_Term
metabole acidose	Specific_Term
metabole neuropathie	Specific_Term
metabolieten	Specific_Term
metastasen	Specific_Term
metformine	Specific_Term
metoprolol	Specific_Term
metoprolol sr	Specific_Term
metoprololgroep	Specific_Term
metoprololonderzoek	Specific_Term
metoprololsuccinaat	Specific_Term
mfm	Named_Entity
mi	Specific_Term
mice-score	Named_Entity
microal-buminurie	Specific_Term
microalbuminurie	Specific_Term
microcytair bloedbeeld	Specific_Term
micromanometerkatheters	Specific_Term
midclaviculairlijn	Specific_Term
mild hartfalen	Specific_Term
mitralis	Specific_Term
mitralis-aortaklepinsufficiëntie	Specific_Term
mitralisklep	Specific_Term
mitralisklepafwijking	Specific_Term
mitralisklepinsufficiëntie	Specific_Term
mitralisklepplastiek	Specific_Term
monogenetische erfelijke aandoeningen	Specific_Term
monotherapie	Specific_Term
morbiditeit	Specific_Term
morfine	Common_Term
morfine-analogen	Specific_Term
mortaliteit	Specific_Term
mortaliteitsafname	Specific_Term
mortaliteitsgegevens	Specific_Term
mortaliteitsrisico	Specific_Term
mortaliteitsverlagend	Specific_Term
mri	Specific_Term
ms	Specific_Term
mswt	Specific_Term
multi-organ failure	Specific_Term
multidisciplinaire ketenzorg	Specific_Term
multidisciplinaire richtlijn	Specific_Term
multidisciplinaire richtlijn hartfalen	Named_Entity
multifactoriële aandoening	Specific_Term
multifactoriële aandoeningen	Specific_Term
multivariabele logistische regressie	OOD_Term
multivariabele regressieanalyse	OOD_Term
multivariate analyse	OOD_Term
multivariate regressieanalyse	OOD_Term
murray	Named_Entity
myocard	Specific_Term
myocardfibrose	Specific_Term
myocardfunctie	Specific_Term
myocardiale	Specific_Term
myocardiale perfusiescintigrafie	Specific_Term
myocardiale zuurstofverbruik	Specific_Term
myocardinfarct	Specific_Term
myocardinfarct met st-segmentelevatie	Specific_Term
myocardinfarcten	Specific_Term
myocardischemie	Specific_Term
myocardweefsel	Specific_Term
myocardziekten	Specific_Term
myocyt	Specific_Term
myocyten	Specific_Term
n-terminaal anp	Specific_Term
n-terminaal pro-bnp	Specific_Term
n-terminaal pro-breinnatriuretisch peptide	Specific_Term
n-terminaal probnp	Specific_Term
n-terminal-probnp	Specific_Term
na	Specific_Term
nabelasting	Specific_Term
nachtelijke prikkelhoest	Specific_Term
naproxen	Specific_Term
national heart, lung, and blood institute	Named_Entity
natrium	Specific_Term
natriumarm	Specific_Term
natriumarme	Specific_Term
natriumbeperking	Specific_Term
natriumconcentratie	Specific_Term
natriuminname	Specific_Term
natriumintake	Specific_Term
natriumretentie	Specific_Term
natriumsuppletie	Specific_Term
natriumuitscheiding	Specific_Term
natriuretisch	Specific_Term
natriuretisch peptide	Specific_Term
natriuretische	Specific_Term
natriuretische peptiden	Specific_Term
nebivolol	Specific_Term
necrose	Specific_Term
necrotische cellen	Specific_Term
nederland	Named_Entity
nederlands huisartsen genootschap	Named_Entity
nederlandse eerstelijns diabetesrichtlijn	Named_Entity
nederlandse hartstichting	Named_Entity
nefrologische	Specific_Term
nefroloog	Specific_Term
nefronen	Specific_Term
negatief chronotroop geneesmiddel	Specific_Term
negatief inotrope medicatie	Specific_Term
negatief inotrope middelen	Specific_Term
negatief voorspellende waarde	OOD_Term
neprilysine	Specific_Term
neprilysine remmer	Specific_Term
neprilysine-receptoren	Specific_Term
nesiritide	Specific_Term
neurohormonale	Specific_Term
neurohormonale systemen	Specific_Term
neurohormonen	Specific_Term
neurohormoonbepalingen	Specific_Term
neurohumorale	Specific_Term
neurohumorale systemen	Specific_Term
neuropathie	Specific_Term
new england	Named_Entity
new england journal of medicine	Named_Entity
new york	Named_Entity
new york heart association	Named_Entity
nhg	Named_Entity
nhg-patiëntenbrieven	Named_Entity
nhg-standaard	Named_Entity
nhg-standaard atriumfibrilleren	Named_Entity
nhg-standaard diabetes mellitus	Named_Entity
nhg-standaard diabetes mellitus type 2	Named_Entity
nhg-standaard hartfalen	Named_Entity
nier	Common_Term
nierarteriestenose	Specific_Term
nierdoorstroming	Specific_Term
nieren	Common_Term
nierfalen	Common_Term
nierfunctie	Common_Term
nierfuncties	Common_Term
nierfunctiestoornis	Specific_Term
nierfunctiestoornissen	Specific_Term
nierfunctieverlies	Common_Term
nierfunctievermindering	Common_Term
nierfunctieverslechtering	Common_Term
nierinsufficientie	Specific_Term
nierinsufficiëntie	Specific_Term
nierperfusie	Specific_Term
nierperfusiestoornis	Specific_Term
nierschade	Common_Term
niertubulus	Specific_Term
niet-dihydropyridine calciumantagonisten	Specific_Term
niet-farmacologische	Common_Term
niet-farmacologische behandeling	Common_Term
niet-gerandomiseerd	OOD_Term
niet-gerandomiseerde	OOD_Term
niet-ischemische	Specific_Term
niet-ischemische cardiomyopathie	Specific_Term
niet-medicamenteus	Common_Term
niet-medicamenteuze	Common_Term
niet-medicamenteuze behandeling	Common_Term
niet-steroïde anti-inflammatoire geneesmiddelen	Specific_Term
nifedipine	Specific_Term
nitraatgebruik	Specific_Term
nitraten	Specific_Term
nitroglycerine	Specific_Term
no	Specific_Term
non-invasief	Specific_Term
non-occlusieve mesenteriale ischemie	Specific_Term
non-steroidal anti-inflammatory drugs	Specific_Term
non-steroïde anti-inflammatoire geneesmiddelen	Specific_Term
npv	OOD_Term
nsaid	Specific_Term
nsaid's	Specific_Term
nt-anp	Specific_Term
nt-pro-bnp	Specific_Term
nt-probnp	Specific_Term
nt-probnp-bepaling	Specific_Term
nt-probnp-bepalingen	Specific_Term
nt-probnp-plasmaspiegels	Specific_Term
ntprobnp	Specific_Term
ntvg	Named_Entity
number needed to harm	Specific_Term
nurse practitioner	Specific_Term
nycturie	Specific_Term
nyha	Named_Entity
nyha klasse 2	Specific_Term
nyha klasse ii	Specific_Term
nyha-klasse 3	Specific_Term
nyha-klasse ii	Specific_Term
nyha-klasse iii	Specific_Term
nyha-klasse iv	Specific_Term
obesitas	Common_Term
obgvm	Specific_Term
obstructief longlijden	Specific_Term
obstructieve hartklepaandoeningen	Specific_Term
obstructieve longfunctieafwijkingen	Specific_Term
oedeem	Specific_Term
oedemateuze	Specific_Term
oedemen	Specific_Term
oestrogeenagonistische	Specific_Term
olivetti	Named_Entity
omapatrilaat	Specific_Term
omega-3-vetzuren	Specific_Term
omzettingssnelheid	Specific_Term
onbloedig	Specific_Term
onbloedige	Specific_Term
onbloedige cvd-metingen	Specific_Term
oncologische	Common_Term
onderbehandeling	Common_Term
onderdiagnostiek	Specific_Term
onderhoudsmedicatie	Common_Term
onderste longvelden	Specific_Term
ondersteuningspompen	Specific_Term
one-stop shop	OOD_Term
onstabiele angina	Specific_Term
onstabiele angina pectoris	Specific_Term
ontslagdiagnose	Specific_Term
ontsteking	Common_Term
ontstekingsremmende	Common_Term
ontstekingsremmers	Common_Term
ontwatering	Specific_Term
open hartchirurgie	Common_Term
operatie	Common_Term
operaties	Common_Term
operatieve	Common_Term
opgenomen	Common_Term
opgetitreerd	Specific_Term
opiaten	Specific_Term
opioïden	Specific_Term
opname	Common_Term
opnamen	Common_Term
oppervlakte onder de roc-curve	OOD_Term
optitreerfase	Specific_Term
optitreren	Specific_Term
or	OOD_Term
oraal	Common_Term
oraal bloedglucoseverlagend geneesmiddel	Specific_Term
orale	Common_Term
orgaan	Common_Term
organen	Common_Term
oromucosaal	Specific_Term
orthopneu	Specific_Term
orthopnoe	Specific_Term
orthostatische hypotensie	Specific_Term
orthosympathisch zenuwstelsel	Specific_Term
ossale metastasen	Specific_Term
osteoporose	Specific_Term
osteosarcomen	Specific_Term
osteosarcoom	Specific_Term
overdiagnostiek	Specific_Term
overlijdensrisico	Common_Term
oversterfte	Specific_Term
overvulling	Specific_Term
p	OOD_Term
p450-systeem	Specific_Term
pacemaker	Common_Term
pacemakerritme	Specific_Term
pacemakers	Common_Term
pahor	Named_Entity
palliatie	Common_Term
palliatief	Common_Term
palliatieve	Common_Term
palliatieve zorg	Common_Term
palliatiezorgteam	Common_Term
palmoplantaire erytrodysesthesie	Specific_Term
palpabel	Specific_Term
palpitaties	Specific_Term
paracorporeel systeem	Specific_Term
paradigm-hf	Named_Entity
parasympathische	Specific_Term
parasympathische inhibitie	Specific_Term
parasympatische activiteit	Specific_Term
parenteraal	Specific_Term
paroxismale nachtelijke benauwdheid	Specific_Term
paroxismale nachtelijke dyspneu	Specific_Term
paroxysmale nachtelijke dyspnoe	Specific_Term
pars ascendens aortae	Specific_Term
partiële linker ventriculectomie	Specific_Term
partiële ventriculectomie	Specific_Term
pathofysiologie	Specific_Term
pathofysiologisch	Specific_Term
pathofysiologische	Specific_Term
pathogene	Specific_Term
pathogene mutatie	Specific_Term
pathognomonische	Specific_Term
pathologie	Specific_Term
pathologieën	Specific_Term
pathologisch	Specific_Term
pathologische	Specific_Term
pathologische q-toppen	Specific_Term
patienten	Common_Term
patiënt	Common_Term
patiënte	Common_Term
patiënten	Common_Term
patiëntencategorie	Common_Term
patiëntencategorieën	Common_Term
patiëntengroep	Common_Term
patiëntengroepen	Common_Term
patiëntenvoorlichting	Common_Term
patiëntenzorg	Common_Term
pci	Specific_Term
pco2	Specific_Term
peace	Named_Entity
pearson's product moment correlatiecoëfficiënt	OOD_Term
peptide	Specific_Term
peptiden	Specific_Term
percutane	Specific_Term
percutane coronaire interventie	Specific_Term
perfunderen	Specific_Term
perfusie	Specific_Term
perfusiescintigrafie	Specific_Term
pericardaandoeningen	Specific_Term
perifeer arterieel vaatlijden	Specific_Term
perifeer bloed	Specific_Term
perifeer oedeem	Specific_Term
perifeer vaatlijden	Specific_Term
perifere circulatie	Specific_Term
perifere oedemen	Specific_Term
perifere vaten	Specific_Term
perifere weerstand	Specific_Term
perindopril	Specific_Term
perindoprilgebruik	Specific_Term
perioperatief	Specific_Term
perioperatieve	Specific_Term
peripartum	Specific_Term
peripartum cardiomyopathie	Specific_Term
peristaltiek	Specific_Term
pijn	Common_Term
pioglitazon	Specific_Term
pitting oedeem	Specific_Term
plaatjesaggregatie	Specific_Term
plaatjesaggregatieremmer	Specific_Term
plaatjesremmers	Specific_Term
placebo	Common_Term
placebobehandelde	Common_Term
placebogebruikers	Common_Term
placebogroep	Common_Term
placebopil	Common_Term
placebopillen	Common_Term
plasma	Specific_Term
plasma-bnp-concentratie	Specific_Term
plasma-bnp-waarde	Specific_Term
plasma-osmolaliteit	Specific_Term
plasmaconcentratie	Specific_Term
plasmaconcentratie-tijdcurve	Specific_Term
plasmaconcentraties	Specific_Term
plasmaspiegel	Specific_Term
plasmaspiegels	Specific_Term
pleiotrope	Specific_Term
pleura-effusie	Specific_Term
pleuravocht	Specific_Term
plotse hartdood	Specific_Term
pneumokokkenvaccinatie	Specific_Term
pneumonie	Specific_Term
po2	Specific_Term
polen	Named_Entity
polikliniek	Common_Term
polikliniekbezoek	Common_Term
poliklinieken	Common_Term
poliklinisch	Common_Term
poliklinische	Common_Term
polsdruk	Specific_Term
polsfrequentie	Specific_Term
polsgolf	Specific_Term
polsslag	Common_Term
polyfarmacie	Specific_Term
polymorfisme	Specific_Term
polymorfismen	Specific_Term
pompfunctie	Common_Term
positief inotropicum	Specific_Term
positief voorspellende waarde	OOD_Term
positieve venepols	Specific_Term
postacute	Specific_Term
postglomerulaire arteriole	Specific_Term
postoperatief	Common_Term
ppv	OOD_Term
precordiale	Specific_Term
pretransplantatiekandidaten	Specific_Term
pretransplantatiepatiënten	Specific_Term
prevalentie	Specific_Term
prevalentiecijfers	Specific_Term
prevalentiestijging	Specific_Term
prevention of events with angiotensin converting enzyme inhibition	Named_Entity
prikkelhoest	Specific_Term
primaire cardiomyopathie	Specific_Term
primaire eindpunt	Specific_Term
primaire eindpunten	Specific_Term
primaire uitkomsten	Specific_Term
pro-bnp	Specific_Term
pro-breinnatriuretisch peptide	Specific_Term
proatherosclerotische mechanismen	Specific_Term
probnp	Specific_Term
proeflaparotomie	Specific_Term
prognose	Common_Term
prognostisch	Common_Term
prognostische	Common_Term
progressief hartfalen	Specific_Term
progressief rechterventrikelfalen	Specific_Term
proliferatie	Specific_Term
propafenon	Specific_Term
prospectief	Specific_Term
prospectief cohortonderzoek	OOD_Term
prospectief longitudinaal multipel gevalsonderzoek	OOD_Term
prospectieve	Specific_Term
prospectieve cohortonderzoek	OOD_Term
prospectieve onderzoeken	OOD_Term
prostaathypertrofie	Specific_Term
prostaglandinen	Specific_Term
prostaglandinesynthese	Specific_Term
proto-oncogenen	Specific_Term
proximaal tubulair	Specific_Term
psychofarmaca	Specific_Term
psychologische	Common_Term
psychopathologie	Specific_Term
ptca	Specific_Term
publicatiebias	OOD_Term
pulmonaal	Specific_Term
pulmonaal piepen	Specific_Term
pulmonale	Specific_Term
pulmonale aandoening	Specific_Term
pulmonale bijgeluiden	Specific_Term
pulmonale crepitaties	Specific_Term
pulmonale dyspneu	Specific_Term
pulmonale overvulling	Specific_Term
pulmonale pathologie	Specific_Term
pulsaties	Specific_Term
punctum maximum	Specific_Term
qrs	Specific_Term
qrs-complex	Specific_Term
qrs-duur	Specific_Term
qs-complexen	Specific_Term
r	OOD_Term
raas	Specific_Term
raas-systeem	Specific_Term
radiance	Named_Entity
radioimmunoassaytechnieken	Specific_Term
radioloog	Common_Term
radionuclidemetingen	Specific_Term
rales	Named_Entity
raltitrexed	Specific_Term
ramipril	Specific_Term
ramus circumflexus	Specific_Term
ramus descendens anterior	Specific_Term
randomisatie	OOD_Term
randomiseerden	OOD_Term
randomized aldactone evaluation study	Named_Entity
randomized assessment of digoxin on inhibitors of the angiotensin converting enzyme	Named_Entity
randomized spironalactone evaluation study	Named_Entity
range	OOD_Term
rattencardiomyocyten	Specific_Term
rct	OOD_Term
rct's	OOD_Term
re-entry-mechanismen	Specific_Term
reanimatierichtlijnen	Specific_Term
reanimeren	Common_Term
receptor	Specific_Term
receptoren	Specific_Term
receptorstructuur	Specific_Term
rechter atrium	Specific_Term
rechter bundeltakblokpatroon	Specific_Term
rechter ventrikel	Specific_Term
rechter vullingsdrukken	Specific_Term
rechteratriumdruk	Specific_Term
rechterventrikel	Specific_Term
rechterventrikelfalen	Specific_Term
rechtszijdig hartfalen	Specific_Term
recidiefhartfalen	Specific_Term
recidiefmyocardinfarct	Specific_Term
reflextachycardie	Specific_Term
regressiemodel	OOD_Term
rehospitalisatie	Common_Term
rekatheterisatie	Specific_Term
relatief risico	Specific_Term
relatieve-risicoreductie	OOD_Term
relaxatietijd	Specific_Term
relaxatieverloop	Specific_Term
remodellering	Specific_Term
renaal	Specific_Term
renaal falen	Specific_Term
renale	Specific_Term
renale klaring	Specific_Term
renine	Specific_Term
renine remmers	Specific_Term
renine-angiotensine-aldosteron systeem	Specific_Term
renine-angiotensine-aldosteron-systeem	Specific_Term
renine-angiotensine-aldosteronsysteem	Specific_Term
renine-angiotensine-antagonisten	Specific_Term
renovasculair lijden	Specific_Term
reperfusie	Specific_Term
resuscitatie	Specific_Term
resynchronisatietherapie	Specific_Term
retentie van water	Specific_Term
retrospectief statusonderzoek	OOD_Term
reumatoïde	Specific_Term
reumatoïde artritis	Specific_Term
revalidatieprogramma's	Common_Term
revascularisatie	Specific_Term
revascularisatie-ingreep	Specific_Term
reversibele luchtwegobstructie	Specific_Term
reversibiliteit	Specific_Term
reïnfarct	Specific_Term
rhonchi	Specific_Term
richtlijn hartrevalidatie 2004	Named_Entity
rikssvikt	Named_Entity
ritmestoornis	Common_Term
ritmestoornissen	Common_Term
rivm	Named_Entity
roche-diagnostics	Named_Entity
roche-therapeutics	Named_Entity
rosiglitazon	Specific_Term
rosuvastatine	Specific_Term
rr	Specific_Term
rule-in	Specific_Term
rule-out	Specific_Term
rx-thorax	Specific_Term
röntgenfoto	Common_Term
röntgenonderzoek	Common_Term
röntgenthoraxfotografie	Specific_Term
s3 galop	Specific_Term
sacrum	Specific_Term
samengesteld eindpunt	Specific_Term
samengestelde eindpunt	Specific_Term
savor-timi 53	Named_Entity
saxagliptine	Specific_Term
sd	OOD_Term
segmentale contractie-relaxatiepatronen	Specific_Term
seh	Common_Term
sensitiviteit	Specific_Term
serumcholesterol	Specific_Term
serumconcentraties	Specific_Term
serumcreatinine	Specific_Term
serumcreatinineconcentratie	Specific_Term
serumcreatininespiegel	Specific_Term
serumdigoxineconcentratie	Specific_Term
serumelektrolyten	Specific_Term
serumkalium	Specific_Term
serumkaliumconcentratie	Specific_Term
serumkaliumgehalte	Specific_Term
serumkaliumstijging	Specific_Term
sexual adjustment scale	Named_Entity
sglt-2-remmer	Specific_Term
sglt-2-remmers	Specific_Term
shafiq	Named_Entity
shock	Common_Term
shropshire	Named_Entity
shuttle wandel test	Specific_Term
sick sinus syndrome	Specific_Term
siginficant	OOD_Term
significant	OOD_Term
significante	OOD_Term
significantieniveau	OOD_Term
single group measurement design	OOD_Term
single nucleotide polymorphism	Specific_Term
sinusbradycardie	Specific_Term
sinusritme	Specific_Term
slaapapneu	Common_Term
slagvolume	Specific_Term
snp	Specific_Term
sodium	Common_Term
souffles	Specific_Term
spanje	Named_Entity
specificiteit	Specific_Term
speckle-echo	Specific_Term
speckle-tracking echocardiografie	Specific_Term
spier	Common_Term
spiercellen	Common_Term
spiercelverlies	Specific_Term
spieren	Common_Term
spirometrie	Specific_Term
spironolacton	Specific_Term
spironolactone	Specific_Term
spironolactongroep	Specific_Term
spoedeisende hulp	Common_Term
spoedeisendehulpafdeling	Common_Term
spoedopvang	Common_Term
ssri's	Specific_Term
st-elevaties	Specific_Term
st-segmentdepressie	Specific_Term
st-segmentelevatie	Specific_Term
st-t-afwijkingen	Specific_Term
stabiel	Common_Term
stabiel chronisch hartfalen	Specific_Term
stabiel hartfalen	Common_Term
stabiele	Common_Term
staessen	Named_Entity
standaardlab	Specific_Term
standaardtherapie	Common_Term
starttherapie	Common_Term
statine	Specific_Term
statines	Specific_Term
stemi	Specific_Term
sterfte	Common_Term
sterftereductie	Common_Term
sterftevermindering	Common_Term
steroïde	Common_Term
steunhart	Specific_Term
stichting huisartsen laboratorium etten-leur	Named_Entity
stolselvorming	Specific_Term
stomatitis	Specific_Term
studiepatiënten	Common_Term
stuwing	Specific_Term
stuwing van de lever	Common_Term
stuwingsbeeld	Specific_Term
subendocardiale infarcering	Specific_Term
sublinguaal	Specific_Term
sublinguale	Specific_Term
swan-ganz-katheter	Specific_Term
swt	Specific_Term
sympathicomimetische	Specific_Term
sympathicus	Specific_Term
sympathicus-tonus	Specific_Term
sympathicusactiviteit	Specific_Term
sympatholytisch	Specific_Term
symptomatisch	Common_Term
symptomatisch hartfalen	Specific_Term
symptomatisch systolisch hartfalen	Specific_Term
symptomatische	Common_Term
symptomatische hypotensie	Specific_Term
symptomatische systemische ventriculaire systolische disfunctie	Specific_Term
symptomatologie	Specific_Term
symptomen	Common_Term
symptoom	Common_Term
symptoomverbetering	Common_Term
syncope	Specific_Term
syndromen	Common_Term
syndroom	Common_Term
systemisch	Specific_Term
systemische	Specific_Term
systemische bloeddruk	Specific_Term
systemische perifere weerstand	Specific_Term
systole	Specific_Term
systolisch	Specific_Term
systolisch functieverlies	Specific_Term
systolisch hartfalen	Specific_Term
systolische	Specific_Term
systolische bloeddruk	Specific_Term
systolische disfunctie	Specific_Term
systolische disfunctie van het linker ventrikel	Specific_Term
systolische functie	Specific_Term
systolische functiestoornis	Specific_Term
systolische linkerventrikeldisfunctie	Specific_Term
systolische linkerventrikelfunctie	Specific_Term
systolische ruis	Specific_Term
systolische ventriculaire dysfunctie	Specific_Term
t2dm	Specific_Term
tachyaritmieën	Specific_Term
tachycard	Specific_Term
tachycardie	Specific_Term
tachycardieën	Specific_Term
tachypneu	Specific_Term
tachypnoïsche ademhaling	Specific_Term
tartraat	Specific_Term
technetium-99m-sestamibi	Specific_Term
telemonitoring	Specific_Term
tenecteplase	Specific_Term
terminaal	Common_Term
terminaal hartfalen	Common_Term
terminal deoxynucleotidyl transferase-mediated deoxyuridine triphosphate	Specific_Term
terminale	Common_Term
terminale zorg	Common_Term
tertielwaarde	OOD_Term
thalidomide	Specific_Term
the antihypertensive and lipid-lowering treatment to prevent heart attack trial	Named_Entity
the lancet	Named_Entity
therapeuticum	Specific_Term
therapeutisch	Common_Term
therapeutische	Common_Term
therapie	Common_Term
therapieduur	Common_Term
therapiekeuze	Common_Term
therapieprotocol	Specific_Term
therapieresistente	Specific_Term
therapietrouw	Common_Term
therapieën	Common_Term
thermocardiosystems	Named_Entity
thiazide	Specific_Term
thiazideachtig	Specific_Term
thiazidediuretica	Specific_Term
thiazides	Specific_Term
thiazolidinedionderivaten	Specific_Term
thiazolidinedionen	Specific_Term
thorax	Specific_Term
thoraxcentrum	Named_Entity
thoraxfoto	Specific_Term
thromboxaan a2	Specific_Term
thuisinfusie	Specific_Term
thuisinfusiebehandeling	Specific_Term
thuisinfusietherapie	Specific_Term
thuiszorg	Common_Term
thuiszorgprogramma	Common_Term
thuiszorgverpleegkundigen	Common_Term
thymidinefosforylase	Specific_Term
thyreotoxicose	Specific_Term
tia	Specific_Term
titratie	Specific_Term
titreer	Specific_Term
titrerend	Specific_Term
topcat	Named_Entity
torasemide	Specific_Term
torsades de pointes	Specific_Term
trandolapril	Specific_Term
transferrinesaturatie	Specific_Term
transmurale zorg	Specific_Term
transplantatie	Common_Term
trastuzumab	Specific_Term
trastuzumabtherapie	Specific_Term
treatment of preserved cardiac function heart failure with an aldosterone antagonist trial	Named_Entity
triamtereen	Specific_Term
tricuspidalisinsufficiëntie	Specific_Term
tricuspidalisklep	Specific_Term
tricuspidalisklepplastiek	Specific_Term
tricuspidalisklepvlak	Specific_Term
tripeltherapie	Specific_Term
troglitazon	Specific_Term
trombi	Specific_Term
trombo-embolie	Specific_Term
trombo-embolische	Specific_Term
trombose	Specific_Term
trombusvorming	Specific_Term
troponine	Specific_Term
troponine t	Specific_Term
tsh	Specific_Term
tumor	Common_Term
tumoren	Common_Term
tumorweefsel	Common_Term
tunel	Specific_Term
turgor	Specific_Term
tweezijdig basaal crepiteren	Specific_Term
tweezijdige nierarteriestenose	Specific_Term
type 2 diabetes	Specific_Term
type 2 diabetes mellitus	Specific_Term
uitgangswaarde	OOD_Term
universitair medisch centrum	Named_Entity
uremie	Specific_Term
ureum	Specific_Term
ureumconcentratie	Specific_Term
usa	Named_Entity
uzleuven	Named_Entity
v. cava inferior	Specific_Term
v. cava superior	Specific_Term
v. jugularis	Specific_Term
v. jugularis externa	Specific_Term
v. jugularis interna	Specific_Term
vaat-vernauwende	Specific_Term
vaatanatomie	Specific_Term
vaatlijden	Specific_Term
vaatstenoses	Specific_Term
vaatvernauwende	Specific_Term
vaatverwijdende	Specific_Term
vaatverwijders	Specific_Term
vaatwand	Specific_Term
vaatwandeigenschappen	Specific_Term
vaatziekte	Common_Term
vaatziekten	Common_Term
vaatziektes	Common_Term
vad	Specific_Term
vagotoon	Specific_Term
val-heft	Named_Entity
valsalva-manoeuvre	Specific_Term
valsartan	Specific_Term
variantgenen	Specific_Term
vas efferens	Specific_Term
vasculaire	Specific_Term
vasculaire aandoening	Specific_Term
vasoconstrictie	Specific_Term
vasodilatatie	Specific_Term
vasodilaterende	Specific_Term
vasopeptidase-remmer	Specific_Term
vena-cava-superiorisyndroom	Specific_Term
vene	Specific_Term
venen	Specific_Term
venepols	Specific_Term
venetakken	Specific_Term
veneuze	Specific_Term
veneuze afvloed	Specific_Term
veneuze boog	Specific_Term
veneuze insufficiëntie	Specific_Term
veneuze leverstuwing	Specific_Term
veneuze longstuwing	Specific_Term
veneuze longvaatbed	Specific_Term
veneuze pulsaties	Specific_Term
veneuze stuwing	Specific_Term
veneuze stuwing van de lever	Specific_Term
veneuze systeem	Specific_Term
ventriculaire	Specific_Term
ventriculaire aritmie	Specific_Term
ventriculaire aritmieën	Specific_Term
ventriculaire pacing	Specific_Term
ventriculaire remodelerende chirurgie	Specific_Term
ventricular assist devices	Specific_Term
ventriculectomie	Specific_Term
ventrikel	Specific_Term
ventrikeldiastole	Specific_Term
ventrikeldisfunctie	Specific_Term
ventrikelfibrillatie	Specific_Term
ventrikelfibrilleren	Specific_Term
ventrikelfrequentie	Specific_Term
ventrikelfunctie	Specific_Term
ventrikelrespons	Specific_Term
ventrikelseptum	Specific_Term
ventrikelseptumruptuur	Specific_Term
verapamil	Specific_Term
verenigde staten	Named_Entity
verlaagde ejectiefractie	Specific_Term
verminderde ejectiefractie	Specific_Term
verpleegkundige	Common_Term
verpleegkundigen	Common_Term
verplegen	Common_Term
vervolgdiagnostiek	Common_Term
vesiculair ademgeruis	Specific_Term
vesnarinon	Specific_Term
vetweefsel	Common_Term
vierde harttoon	Specific_Term
viscerale	Specific_Term
viscerale organen	Specific_Term
visusstoornissen	Specific_Term
vitale organen	Common_Term
vitamine e	Common_Term
vitamine-e-suppletie	Specific_Term
vkorc1	Specific_Term
vo2	Specific_Term
vo2-piek	Specific_Term
vochtbeperking	Specific_Term
vochtrestrictie	Specific_Term
vochtretentie	Specific_Term
vochtsuppletie	Specific_Term
voeding bij hartfalen	Named_Entity
voetzoolreflexen	Common_Term
volemische	Specific_Term
volumebelasting	Specific_Term
volumedepletie	Specific_Term
voor-achterwaartse thoraxdiameter	Specific_Term
voor-achterwaartse thoraxdiameters	Specific_Term
voorbelasting	Specific_Term
voorgeschiedenis	Common_Term
voorgeschreven	Common_Term
voorkamerfibrillatie	Specific_Term
voorschrift	Common_Term
voorwandafleidingen	Specific_Term
vs	Named_Entity
vullingsdruk	Specific_Term
vullingsdrukken	Specific_Term
vullingsdynamiek	Specific_Term
wandspanning	Specific_Term
warcef	Named_Entity
warfarin versus aspirin in reduced cardiac ejection fraction	Named_Entity
warfarine	Specific_Term
waterretentie	Specific_Term
waterretinerende neurohormonen	Specific_Term
waterzucht	Specific_Term
weefselhypoperfusie	Specific_Term
weefselperfusie	Specific_Term
werkdiagnose	Common_Term
werkgroep kindertumoren	Named_Entity
wet van laplace	Specific_Term
wgbo	Named_Entity
wikkelhart	Specific_Term
william withering	Named_Entity
woburn	Named_Entity
würzburg	Named_Entity
x-thorax	Specific_Term
zelfmedicatie	Common_Term
ziekbed	Common_Term
zieke	Common_Term
zieken	Common_Term
ziekenhuis	Common_Term
ziekenhuismaterialen	Common_Term
ziekenhuisopname	Common_Term
ziekenhuisopnamen	Common_Term
ziekenhuisopnames	Common_Term
ziekenhuistherapie	Common_Term
ziekenhuisverplaatsende zorg	Specific_Term
ziekenhuizen	Common_Term
ziekte	Common_Term
ziekte van alzheimer	Common_Term
ziektebeeld	Common_Term
ziektebeelden	Common_Term
ziektebeloop	Common_Term
ziektegeschiedenis	Common_Term
ziektekostenverzekeraar	Common_Term
ziekten	Common_Term
ziekteprogressie	Common_Term
zorgsysteem	Common_Term
zorgverleners	Common_Term
zorgvoorzieningen	Common_Term
zoutrestrictie	Specific_Term
zoutretentie	Specific_Term
zuurstofopnamekinetiek	Specific_Term
zuurstofsaturatie	Specific_Term
zuurstofsaturatiemeting	Specific_Term
zweden	Named_Entity
ß-blokkade	Specific_Term
ß-blokker	Specific_Term
ß-blokkers	Specific_Term
ß-receptor	Specific_Term
ß1-adrenerge receptor	Specific_Term
ß1-adrenerge receptoren	Specific_Term
ß1-receptor	Specific_Term
ß2-receptoren	Specific_Term
α-blokker	Specific_Term
β-blokker	Specific_Term
β-blokkers	Specific_Term
β-receptorblokkerende sympathicolytica	Specific_Term
βètablokkers	Specific_Term
